Some would say that life is like a box of metaphors.  I would not say that.  I would say life is a land of metaphors.  You come to this land perhaps from a hidden door in the back of a piece of furniture, perhaps from a door in a dream.  Either way, you find yourself here.

The Land of Breakfast and Lunch
An Interactive Fiction by Daniel Talsky
Release 1 / Serial number 200216 / Inform 7 build 6M62 (I6/v6.33 lib 6/12N) SD

Path
You are at the beginning of a path.  It is plain, even homely.  It leads northward towards The Land of Breakfast and Lunch.  If you "walk north" you will follow the path.

>n
The Land of Breakfast and Lunch
The Land of Breakfast and Lunch is a lot smaller than you were expecting.  It's actually just a small clearing near the road, like a roadside stop, with a painted picnic table containing a simple but nourishing breakfast on one end, and a simple but nourishing lunch on the other end.  A stubby little path leads south, and the path continues to the north, towards The Land of Unrealized Possibilities.  If you "walk north" you will be walking towards it.

You can see a painted picnic table (on which are Breakfast and Lunch) here.

>n
Hopeful Path
You are on the hopeful path.  To the south is The Land of Breakfast and Lunch.  To the north is The Land of Unrealized Possiblities.

>n
The Land of Unrealized Possiblities
You are in the Land of Unrealized Possibilities.  Just being here gives you a sense of all that could be accomplished if enough time, effort, and focus were pointed in a specific direction.  There is an sense of both excitement and disappointment here that is almost palpable.  The Hopeful Path leads southward towards The Land of Breakfast and Lunch, a place with a much clearer sense of purpose.

You can see a toy box (closed) here.

>open box
You open the toy box, revealing a wooden block, a small heart shaped locket, and a small hobby horse.

* * *

>forward
The Land of Breakfast and Lunch
The Land of Breakfast and Lunch is a lot smaller than you were expecting.  It's actually just a small clearing near the road, like a roadside stop, with a painted picnic table containing a simple but nourishing breakfast on one end, and a simple but nourishing lunch on the other end.  A stubby little path leads south, and the path continues to the north, towards The Land of Unrealized Possibilities.  If you "walk north" you will be walking towards it.

You can see a painted picnic table (on which are Breakfast and Lunch) here.

>f
That's not a verb I recognize.

* * *

>f
The Land of Breakfast and Lunch
The Land of Breakfast and Lunch is a lot smaller than you were expecting.  It's actually just a small clearing near the road, like a roadside stop, with a painted picnic table containing a simple but nourishing breakfast on one end, and a simple but nourishing lunch on the other end.  A stubby little path leads south, and the path continues to the north, towards The Land of Unrealized Possibilities.  If you "walk north" you will be walking towards it.

You can see a painted picnic table (on which are Breakfast and Lunch) here.