Some would say that life is like a box of metaphors.  I would not say that.  I would say life is a land of metaphors.  You come to this land perhaps from a hidden door in the back of a piece of furniture, perhaps from a door in a dream.  Either way, you find yourself here.

The Land of Breakfast and Lunch
~ a land can contain both ~ by Daniel Talsky
Release 12 / Serial number 200328 / Inform 7 build 6M62 (I6/v6.34 lib 6/12N) SD

The Path
You are at the beginning of a path.  It is plain, even homely.  It leads forward towards The Land of Breakfast and Lunch.  If you "walk forward" you will follow the path.

I beg your pardon?

I beg your pardon?

>credits
The Land of Breakfast and Lunch was written by Daniel Talsky.

Inspiration and discussion by Hypothesis Archer | http://reptilemind.com

The game's generous and thorough beta testers include:

- Jason "Always Be Testing" Dockins
- Matthew George
- Mike Tarbert
- Caleb "I Smell Everything" Wilson

Last, but not least, I'd like to thank you, the player, personally.  You could be watching Better Call Saul or reading Fyodor Dostoevsky or be playing pinball.  Instead, you're taking the time to explore something I made and I really appreciate it.  I had fun making this, but most of the fun was imaginging you doing what you're doing right now.  Ok, I'll quit, I'm gushing.

* * *

>push button
It is fixed in place.

* * *

>about
You're playing The Land of Breakfast and Lunch, a kind of game or more accurately, a fictional world where you can walk around and waste your time.  There is not a lot of point to it, so just look around and poke around and enjoy yourself, if you like that kind of thing.

There's only one puzzle and you won't miss much if you don't solve it.  

All versions of The Land of Breakfast and Lunch are released under the Creative Commons Attribution-Noncommercial-Share Alike 3.0 license. In summary, you may freely distribute, perform, or create derivative works, but not for commercial purposes without permission from the author. More information is available at http://creativecommons.org/licenses/by-nc-sa/3.0/us/.

>credits
That's not a verb I recognize.

>welcome
That's not a verb I recognize.

>help
That's not a verb I recognize.

* * *

>help
The Land of Breakfast and Lunch is a little place for you to walk around in and look at every little detail.  There are a couple of little tricky things you can accomplish, but there's really no point other than to look at everything and smell everything and laugh at my dumb little jokes.  Sometimes people don't notice the toy box in The Land of Unrealized Possiblities.  Sometimes people don't realize you can "open hatch" and "enter rocket" when you're near the 1950"s rocket.  Yes, there's one little puzzle and it involves the jack-in-the-box, but don't get too concerned about it.  If you need any other help you can just email me at danieltalsky@gmail.com.  I'm happy to help.

* * *

>credits
The Land of Breakfast and Lunch was written by Daniel Talsky and is a [[Rabbit,Rabbit]] production.

Inspiration and 3-D modeled cover art by Hypothesis Archer | http://reptilemind.com

The game's generous and thorough beta testers include:

- Jason "Always Be Testing" Dockins
- Matthew George
- Mike "The Pious" Tarbert
- Caleb "No Stone Unturned" Wilson
- Josh Grams
- Michael "Space Swimmer" Baltes
- Danil Worm

Last, but not least, I'd like to thank you, the player, personally.  You could be watching Better Call Saul or reading Fyodor Dostoevsky or be playing pinball.  Instead, you're taking the time to explore something I made and I really appreciate it.  I had fun making this, but most of the fun was imagining you doing what you're doing right now.

>about
You're playing The Land of Breakfast and Lunch, a kind of game or more accurately, a fictional world where you can walk around and waste your time.  There is not a lot of point to it, so just look around and poke around and enjoy yourself, if you like that kind of thing.

All versions of The Land of Breakfast and Lunch are released under the Creative Commons Attribution-Noncommercial-Share Alike 3.0 license. In summary, you may freely distribute, perform, or create derivative works, but not for commercial purposes without permission from the author. More information is available at http://creativecommons.org/licenses/by-nc-sa/3.0/us/.

* * *

>f
The Land of Breakfast and Lunch
The Land of Breakfast and Lunch is a lot smaller than you were expecting.  It's actually just a small clearing near the road, like a roadside stop, with a painted picnic table containing a simple but nourishing breakfast on one end, and a simple but nourishing lunch on the other end.  A stubby little path leads backwards, and the path continues forward, towards The Land of Unrealized Possibilities.  If you "walk forward" or just "forward" or even just "f" you will be walking towards it.

You can see a painted picnic table (on which are Breakfast and Lunch) here.

>f
Hopeful Path
You are on the hopeful path.  Backwards from here is The Land of Breakfast and Lunch.  Forward is The Land of Unrealized Possibilities.

>f
The Land of Unrealized Possibilities
You are in the Land of Unrealized Possibilities.  Just being here gives you a sense of all that could be accomplished if enough time, effort, and focus were pointed in a specific direction.  There is a sense of both excitement and disappointment here that is almost palpable.  The Hopeful Path leads backward towards The Land of Breakfast and Lunch, a place with a much clearer sense of purpose.  The Seaside Path leads forward, towards The Land of Unlaunched Vessels.

You can see a toy box (closed), a couch (on which is your brother), and a TV here.

>f
Seaside Path
You are on the seaside path.  Backwards from here is The Land of Unrealized Possibilities.  Forward is The Land of Unlaunched Vessels.

>f
The Land of Unlaunched Vessels
You are in The Land of Unlaunched Vessels.  You stand near the edge of the bay, and there is a sailing ship moored here with thick and aged ropes tied to a bollard.  The Hopeful Path leads backward towards The Land of Unrealized Possibilities, a place you're not sure you want to be.  Forward, Sequel Path leads to The Land of Unlaunched Vessels II: The Launchening.

You can see a swarthy hippie seaperson here.

>f
Sequel Path
You are on the sequel path.  Backwards from here is The Land of Unlaunched Vessels.  Forward is The Land of Unlaunched Vessels II: The Launchening.

>f
The Land of Unlaunched Vessels II: The Launchening
You are in The Land of Unlaunched Vessels II: The Launchening.  There is a launchpad here, on which sits a large, 1950's era rocket in galaxy white and candy-apple red. The Sequel Path leads backwards towards The Land of Unlaunched Vessels.  Ahead of you, The Anticlimactic Path probably leads somewhere really amazing.

You can see a launchpad and a rocket here.

>f
Anticlimactic Path
You are on the anticlimactic path.  Backwards is The Land of Unlaunched Vessels II: The Launchening.  Ahead of you, you can see the back of the liquor store.

>f
The Land Behind the Liquor Store
You are in The Land Behind the Liquor Store.  It's underwhelming.  You've got your standard collection of broken down boxes, a dumpster, and a stack of pallets.  Behind you, the anticlimactic path leads to The Land of Unlaunched Vessels II: The Launchening.  Ahead of you, The Path Around the Liquor Store leads to The Land in Front of the Liquor Store.

>f
The Path Around the Liquor Store
You're on the path around the liquor store.  You see the side of the liquor store on one side and a fence on the other side.

>f
The Land in Front of the Liquor Store
The Land in Front of the Liquor Store looks mostly abandoned, and you feel a slight sense of disappointment and dread here.  The liquor store is closed, looks like permanently, and there's just a weird kiddie ride here.  There are marks on the sidewalk where some other metal vending machines were, but it looks like they've been carted away.  Only the kiddie ride remains.

You can see a kiddie ride here.

>f
Idyllic Path

>f
The Land of Puppy Cardiovascular Health
The meadows are wide and rolling here.  

You can see Mr. Tuxedo here.

* * *

>sing
That's not a verb I recognize.

>pray
That's not a verb I recognize.

>credits
The Land of Breakfast and Lunch was written by Daniel Talsky.

Inspiration and discussion by Hypothesis Archer | http://reptilemind.com

The game's generous and thorough beta testers include:

- Jason Dockins
- Matthew George
- Mike Tarbert
- Caleb Wilson.

* * *

>e
Around these parts, folks mostly go backwards or forwards.

>w
You don't see anywhere to go except backwards and forwards.

* * *

>f
The Land of Breakfast and Lunch
The Land of Breakfast and Lunch is a lot smaller than you were expecting.  It's actually just a small clearing near the road, like a roadside stop, with a painted picnic table containing a simple but nourishing breakfast on one end, and a simple but nourishing lunch on the other end.  A stubby little path leads backwards, and the path continues forward, towards The Land of Unrealized Possibilities.  If you "walk forward" or just "forward" or even just "f" you will be walking towards it.

You can see a painted picnic table (on which are Breakfast and Lunch) here.

I beg your pardon?

>f
Hopeful Path
You are on the hopeful path.  Backwards from here is The Land of Breakfast and Lunch.  Forward is The Land of Unrealized Possibilities.

>f
The Land of Unrealized Possibilities
You are in the Land of Unrealized Possibilities.  Just being here gives you a sense of all that could be accomplished if enough time, effort, and focus were pointed in a specific direction.  There is an sense of both excitement and disappointment here that is almost palpable.  The Hopeful Path leads backward towards The Land of Breakfast and Lunch, a place with a much clearer sense of purpose.

You can see a toy box (closed), a couch (on which is your brother), a TV, and a Kiddie Ride here.

>look
The Land of Unrealized Possibilities
You are in the Land of Unrealized Possibilities.  Just being here gives you a sense of all that could be accomplished if enough time, effort, and focus were pointed in a specific direction.  There is an sense of both excitement and disappointment here that is almost palpable.  The Hopeful Path leads backward towards The Land of Breakfast and Lunch, a place with a much clearer sense of purpose.

You can see a toy box (closed), a couch (on which is your brother), a TV, and a Kiddie Ride here.

>put penny in slot
You can't see any such thing.

>look slot
It's a chrome slot to put a coin in.

* * *

>f
Hopeful Path
You are on the hopeful path.  Backwards from here is The Land of Breakfast and Lunch.  Forward is The Land of Unrealized Possibilities.

>f
The Land of Unrealized Possibilities
You are in the Land of Unrealized Possibilities.  Just being here gives you a sense of all that could be accomplished if enough time, effort, and focus were pointed in a specific direction.  There is an sense of both excitement and disappointment here that is almost palpable.  The Hopeful Path leads backward towards The Land of Breakfast and Lunch, a place with a much clearer sense of purpose.

You can see a toy box (closed), a couch (on which is your brother), a TV, and a kiddie ride here.

>change channel
Your brother is holding the remote control.

>change tv
Your brother is holding the remote control.

>change couch
True change comes from within.

>change self
You can only change when you're ready.

>watch tv
An early 35" flatscreen.  Bulky, black, and plastic.  It lived in your den for way too long, just because no one wanted to lift it.  It's odd to see it here, in The Land of Unrealized Possibilities.  It is showing "Beauty and the Embolism" on channel 25.

>watch tv
An early 35" flatscreen.  Bulky, black, and plastic.  It lived in your den for way too long, just because no one wanted to lift it.  It's odd to see it here, in The Land of Unrealized Possibilities.  It is showing "Speed Burners (1975)" on channel 29.

>watch tv
An early 35" flatscreen.  Bulky, black, and plastic.  It lived in your den for way too long, just because no one wanted to lift it.  It's odd to see it here, in The Land of Unrealized Possibilities.  It is showing "Bills and Bennies" on channel 32.

>watch tv
An early 35" flatscreen.  Bulky, black, and plastic.  It lived in your den for way too long, just because no one wanted to lift it.  It's odd to see it here, in The Land of Unrealized Possibilities.  It is showing "The Treinta y Ocho" on channel 39.

>watch tv
An early 35" flatscreen.  Bulky, black, and plastic.  It lived in your den for way too long, just because no one wanted to lift it.  It's odd to see it here, in The Land of Unrealized Possibilities.  It is showing "The Great Snafu (1956)" on channel 18.

>watch tv
An early 35" flatscreen.  Bulky, black, and plastic.  It lived in your den for way too long, just because no one wanted to lift it.  It's odd to see it here, in The Land of Unrealized Possibilities.  It is showing "The Beige Man Group" on channel 17.

>watch tv
An early 35" flatscreen.  Bulky, black, and plastic.  It lived in your den for way too long, just because no one wanted to lift it.  It's odd to see it here, in The Land of Unrealized Possibilities.  It is showing "Speed Burners (1975)" on channel 29.

>watch tv
An early 35" flatscreen.  Bulky, black, and plastic.  It lived in your den for way too long, just because no one wanted to lift it.  It's odd to see it here, in The Land of Unrealized Possibilities.  It is showing "The Treinta y Ocho" on channel 39.

>watch tv
An early 35" flatscreen.  Bulky, black, and plastic.  It lived in your den for way too long, just because no one wanted to lift it.  It's odd to see it here, in The Land of Unrealized Possibilities.  It is showing "Speed Burners (1975)" on channel 29.

>watch tv
An early 35" flatscreen.  Bulky, black, and plastic.  It lived in your den for way too long, just because no one wanted to lift it.  It's odd to see it here, in The Land of Unrealized Possibilities.  It is showing "Enraged Juggalos" on channel 13.

>watch tv
An early 35" flatscreen.  Bulky, black, and plastic.  It lived in your den for way too long, just because no one wanted to lift it.  It's odd to see it here, in The Land of Unrealized Possibilities.  It is showing "Brad!" on channel 28.

>watch tv
An early 35" flatscreen.  Bulky, black, and plastic.  It lived in your den for way too long, just because no one wanted to lift it.  It's odd to see it here, in The Land of Unrealized Possibilities.  It is showing "Bills and Bennies" on channel 32.

>watch tv
An early 35" flatscreen.  Bulky, black, and plastic.  It lived in your den for way too long, just because no one wanted to lift it.  It's odd to see it here, in The Land of Unrealized Possibilities.  It is showing "Wet Planet IV" on channel 14.

>watch tv
An early 35" flatscreen.  Bulky, black, and plastic.  It lived in your den for way too long, just because no one wanted to lift it.  It's odd to see it here, in The Land of Unrealized Possibilities.  It is showing "Access Hollywoo" on channel 20.

>watch tv
An early 35" flatscreen.  Bulky, black, and plastic.  It lived in your den for way too long, just because no one wanted to lift it.  It's odd to see it here, in The Land of Unrealized Possibilities.  It is showing "Bills and Bennies" on channel 32.

>watch tv
An early 35" flatscreen.  Bulky, black, and plastic.  It lived in your den for way too long, just because no one wanted to lift it.  It's odd to see it here, in The Land of Unrealized Possibilities.  It is showing "That 20"s Show" on channel 40.

* * *

>about
The Land of Breakfast and Lunch
~ a land can contain both ~ by Daniel Talsky
Release 3 / Serial number 200308 / Inform 7 build 6M62 (I6/v6.33 lib 6/12N) SD

Standard Rules version 3/120430 by Graham Nelson
Smarter Parser by Aaron Reed
Poor Man's Mistype by Aaron Reed
Epistemology by Eric Eve
Remembering by Aaron Reed
Default Messages by David Fisher
Flexible Windows by Jon Ingold
Improved Menus by Aaron Reed (based on Basic Menus by Emily Short)
Intelligent Hinting by Aaron Reed
Numbered Disambiguation Choices by Aaron Reed.

The official website for Blue Lacuna is lacunastory.com.

Blue Lacuna was first publicly previewed in April 2008 in the Spring Thing Competition. Release 1 debuted in January 2009.

All versions of Blue Lacuna and its source code are released under the Creative Commons Attribution-Noncommercial-Share Alike 3.0 license. In summary, you may freely distribute, perform, or create derivative works, but not for commercial purposes without permission from the author. More information is available at http://creativecommons.org/licenses/by-nc-sa/3.0/us/. The cover art contains photography by Kevin N. Murphy under the Creative Commons Attribution 2.0 Generic license.

* * *

>b
The Path
You are at the beginning of a path.  It is plain, even homely.  It leads forward towards The Land of Breakfast and Lunch.  If you "walk forward" you will follow the path.

>f
The Land of Breakfast and Lunch
The Land of Breakfast and Lunch is a lot smaller than you were expecting.  It's actually just a small clearing near the road, like a roadside stop, with a painted picnic table containing a simple but nourishing breakfast on one end, and a simple but nourishing lunch on the other end.  A stubby little path leads backwards, and the path continues forward, towards The Land of Unrealized Possibilities.  If you "walk forward" or just "forward" or even just "f" you will be walking towards it.

You can see a painted picnic table (on which are Breakfast and Lunch) here.

* * *

>f
The Land of Unrealized Possibilities
You are in the Land of Unrealized Possibilities.  Just being here gives you a sense of all that could be accomplished if enough time, effort, and focus were pointed in a specific direction.  There is a sense of both excitement and disappointment here that is almost palpable.  The Hopeful Path leads backward towards The Land of Breakfast and Lunch, a place with a much clearer sense of purpose.  The Seaside Path leads forward, towards The Land of Unlaunched Vessels.

You can see a toy box (closed), a couch (on which is your brother), and a TV here.

>open box
You open the toy box, revealing a wooden block, a skinny naked plastic doll, a closed jack-in-the-box, a lite-brite, a coloring book, a small heart shaped locket, and a small hobby horse.

>get jack
Taken.

>drop jack
Dropped.

>get box
Which do you mean, the closed jack-in-the-box or the toy box?

>get jack
Taken.

>s
Hopeful Path
You are on the hopeful path.  Backwards from here is The Land of Breakfast and Lunch.  Forward is The Land of Unrealized Possibilities.

>s
The Land of Breakfast and Lunch
The Land of Breakfast and Lunch is a lot smaller than you were expecting.  It's actually just a small clearing near the road, like a roadside stop, with a painted picnic table containing a simple but nourishing breakfast on one end, and a simple but nourishing lunch on the other end.  A stubby little path leads backwards, and the path continues forward, towards The Land of Unrealized Possibilities.  If you "walk forward" or just "forward" or even just "f" you will be walking towards it.

You can see a painted picnic table (on which are Breakfast and Lunch) here.

>s
The Path
You are at the beginning of a path.  It is plain, even homely.  It leads forward towards The Land of Breakfast and Lunch.  If you "walk forward" you will follow the path.

>s
This really is as far back as the path goes.  Further behind you there's just a bunch of scrub brush as far as the eye can see.  It's really not your kind of thing.

>s
This really is as far back as the path goes.  Further behind you there's just a bunch of scrub brush as far as the eye can see.  It's really not your kind of thing.

* * *

I beg your pardon?

>f
You can't go that way.

>press forward
Whoosh.  You thought maybe the engine engaged again, but something else already did.  It bent space softly around you, and, maybe the rocket moved a little.  Like with a soft whoosh.  It happened in less than a second.  Now, you think you're somewhere else.

Kamiro Quadrant
You are inside the rocket as it cruises very slowly through the deep, dark void of space.  Outside the porthole window is the deep, dark void of space covered over with a curtain of stars.

You notice something unusual outside the porthole window.

>g
Whoosh.  You thought maybe the engine engaged again, but something else already did.  It bent space softly around you, and, maybe the rocket moved a little.  Like with a soft whoosh.  It happened in less than a second.  Now, you think you're somewhere else.

Chrysocolla Cluster
You are inside the rocket as it cruises very slowly through the deep, dark void of space.  Outside the porthole window is the deep, dark void of space covered over with a curtain of stars.

You notice something unusual outside the porthole window.

>turn crank
You grasp the little wooden ball and begin to turn the crank as you hold the jack-in-the-box steady.  A dark little tune plinks its way out, echoing forth from the little tin box.  It's not "all around the mulberry bush" or any song you recognize, so you don't quite expect it when its last note ends, and the spring-loaded doll within leaps out with surprising agility.  You jump a tiny bit, in spite of yourself.  The devil doll looks pleased.

The simian businessperson's eyes whip suddenly to the face of the devil doll.  Its eyes widen and turn shockingly pale blue in a clearly recognizable look of total terror.  Their fingers whip forward towards you involuntarily, and you suddenly feel whatever they were holding in the palm of your own hand.  It is a shiny 1964 quarter.  The businessperson looks briefly dismayed but merely pulls something else out of its pocket.

>press land
You can't see any such thing.

>press return
Whoosh. At the end of the rocket's soft whoosh, its mighty engines begin to engage, slowing its fall as it pillows down to the landing pad in The Land of Once Launched Vessels.

The Inside of the Parked Rocket
You are within the smooth walls of the rocket.  It is very plain here, out the porthole window you can see the sky, and out the hatch you can see The Land of Once Launched Vessels.

>exit
You exit the hatch opening and climb to the ground.

The Land of Once Launched Vessels
You are in The Land of Once Launched Vessels.  There is a launchpad here, on which sits a large, 1950's era rocket in galaxy white and candy-apple red. The The Spiritual Sequel Path leads backwards towards The Land of Unlaunched Vessels.  Ahead of you, The Anticlimactic Path probably leads somewhere really amazing.

You can see a launchpad and a rocket here.

>f
Anticlimactic Path
You are on the anticlimactic path.  Backwards is The Land of Once Launched Vessels.  Ahead of you, you can see the back of the liquor store.

>f
The Land Behind the Liquor Store
You are in The Land Behind the Liquor Store.  It's underwhelming.  You've got your standard collection of broken down boxes, a dumpster, and a stack of pallets.  Behind you, the anticlimactic path leads to The Land of Once Launched Vessels.  Ahead of you, The Path Around the Liquor Store leads to The Land in Front of the Liquor Store.

>f
The Path Around the Liquor Store
You're on the path around the liquor store.  You see the side of the liquor store on one side and a fence on the other side.

>f
The Land in Front of the Liquor Store
The Land in Front of the Liquor Store looks mostly abandoned, and you feel a slight sense of disappointment and dread here.  The liquor store is closed, looks like permanently, and there's just a weird kiddie ride here.  There are marks on the sidewalk where some other metal vending machines were, but it looks like they've been carted away.  Only the kiddie ride remains.  It's pretty depressing here, but if you continue to go forward, the Idyllic Path leads to The Land of Puppy Cardiovascular health, which is the final land.

You can see a kiddie ride here.

>put quarter in slot
Gravity pulls the quarter down into the slot, and then there is an agonizing pause before the weight of the quarter trips an internal lever in the machine and its song comes to life.  50% speed in one second, full speed at two seconds.  The song is "In my merry Oldsmobile" and the dance of the humvee is drunken yet tame as it rolls and lists in a pattern potentially thrilling to a 3-year old but usually not really.  If you want to, you can ride the humvee now.

>ride it
You climb up on the molded fiberglass seat of the humvee like a pro and right yourself against its tame rollicking.  At first you find it boring, but you quickly get in the spirit, facetiously adjusting your imaginary cowboy hat and making a quick lasso motion with your wrist to show the yellow humvee you're in full control, despite its raucous bucking.

If this was what you were trying to do, you pretty much won the game, but c'mon, you entered this fictional world with all its richness and descriptions of antipasto and space locations and all you wanted to do is solve its one puzzle?  It's a mood piece, man!  You're just supposed to be relaxed and soak up the sweet, sweet ambience.  That said, none of my beta testers actually got the puzzle on their own.  I didn't think it was that hard since if you trigger the jack-in-the-box in the room you find it in, it freaks your brother out, so I felt like that was a big clue, but I do have a lot of worthless items / red herrings.  What was I talking about?  I dunno, good job though.  I personally suck at puzzles in games so I doubt I would have been able to figure it out myself.

Ok.  I'll admit it.  There might be one even harder puzzle.

* * *

>b
The Path
You are at the beginning of a path.  It is plain, even homely.  It leads forward towards The Land of Breakfast and Lunch.  If you "walk forward" you will follow the path.

>look path
It's a scrubby little path that just kind of tapers off behind you and leads forward towards The Land of Breakfast and Lunch.  If you "walk forward" you'll be following it.

>f
The Land of Breakfast and Lunch
The Land of Breakfast and Lunch is a lot smaller than you were expecting.  It's actually just a small clearing near the road, like a roadside stop, with a painted picnic table containing a simple but nourishing breakfast on one end, and a simple but nourishing lunch on the other end.  A stubby little path leads backwards, and the path continues forward, towards The Land of Unrealized Possibilities.  If you "walk forward" or just "forward" or even just "f" you will be walking towards it.

You can see a painted picnic table (on which are Breakfast and Lunch) here.

* * *

>f
Hopeful Path
You are on the hopeful path.  Backwards from here is The Land of Breakfast and Lunch.  Forward is The Land of Unrealized Possibilities.

>look path
It's a simple, foot-trod path that connects The Land of Breakfast and Lunch and The Land of Unrealized Possibilities.

>f
The Land of Unrealized Possibilities
You are in the Land of Unrealized Possibilities.  Just being here gives you a sense of all that could be accomplished if enough time, effort, and focus were pointed in a specific direction.  There is a sense of both excitement and disappointment here that is almost palpable.  The Hopeful Path leads backward towards The Land of Breakfast and Lunch, a place with a much clearer sense of purpose.  The Seaside Path leads forward, towards The Land of Unlaunched Vessels.

You can see a toy box (closed), a couch (on which is your brother), and a TV here.

* * *

>f
Seaside Path
You are on the seaside path.  Backwards from here is The Land of Unrealized Possibilities.  Forward is The Land of Unlaunched Vessels.

>look path
It's a meandering path that leads away from The Land of Unrealized Possibilities and it technically beside the sea, but quite far away from it.  As you follow it forward it takes you closer to the sea, as well as The Land of Unlaunched Vessels.

>f
The Land of Unlaunched Vessels
You are in The Land of Unlaunched Vessels.  You stand near the edge of the bay, and there is a sailing ship moored here with thick and aged ropes tied to a bollard.  The Hopeful Path leads backward towards The Land of Unrealized Possibilities, a place you're not sure you want to be.  Forward, Sequel Path leads to The Land of Unlaunched Vessels II: The Launchening.

You can see a swarthy hippie seaperson here.

* * *

>f
Sequel Path
You are on the sequel path.  Backwards from here is The Land of Unlaunched Vessels.  Forward is The Land of Unlaunched Vessels II: The Launchening.

>look path
The Sequel Path connects two lands.

>f
The Land of Unlaunched Vessels II: The Launchening
You are in The Land of Unlaunched Vessels II: The Launchening.  There is a launchpad here, on which sits a large, 1950's era rocket in galaxy white and candy-apple red. The Sequel Path leads backwards towards The Land of Unlaunched Vessels.  Ahead of you, The Anticlimactic Path probably leads somewhere really amazing.

You can see a launchpad and a rocket here.

>f
Anticlimactic path
You are on the anticlimactic path.  Backwards is The Land of Unlaunched Vessels II: The Launchening.  Ahead of you, you can see the back of the liquor store.

>look path
It's bound to lead somewhere exciting.

>f
The Land Behind the Liquor Store
You are in The Land Behind the Liquor Store.  It's underwhelming.  You've got your standard collection of broken down boxes, a dumpster, and a stack of pallets.  Behind you, the anticlimactic path leads to The Land of Unlaunched Vessels II: The Launchening.  Ahead of you, The Path Around the Liquor Store leads to The Land in Front of the Liquor Store.

* * *

>credits
The Land of Breakfast and Lunch was written by Daniel Talsky.

Inspiration and discussion by Hypothesis Archer | http://reptilemind.com

Lovely and thorough beta testers include:
Jason Dockins
Matthew George
Mike Tarbert
Caleb Wilson.

* * *

>eat breakfast
(Breakfast)
You sit down for a moment and eat breakfast.  It is delicious but you still don't quite feel satisfied.

>eat lunch
(Lunch)
Lunch was wonderful.  Your stomach feels like a puzzle, where the final piece has finally been snapped into place.  You now feel as if you could take on the world.

>f
Hopeful Path
You are on the hopeful path.  Backwards from here is The Land of Breakfast and Lunch.  Forward is The Land of Unrealized Possibilities.

* * *

>get jack
Taken.

>f
Seaside Path
You are on the seaside path.  Backwards from here is The Land of Unrealized Possibilities.  Forward is The Land of Unlaunched Vessels.

* * *

>f
The Land of Unlaunched Vessels
You are in The Land of Unlaunched Vessels.  You stand near the edge of the bay, and there is a sailing ship moored here with thick and aged ropes tied to a bollard.  The Hopeful Path leads backward towards The Land of Unrealized Possibilities, a place you're not sure you want to be.  Forward, Sequel Path leads to The Land of Unlaunched Vessels II: The Launchening.

You can see a swarthy hippie seaperson here.

>ask hippie about hippie
"I'm just a simple seaperson, I don't know much about the swarthy hippie seaperson."

>ask hippie about hippies
"I don't know what a hippie is.  Is it like a fannie pack?"

* * *

>eat breakfast
(Breakfast)
You sit down for a moment and eat breakfast.  It is delicious but you still don't quite feel satisfied.

>look breakfast
You've politely stacked the breakfast dishes, so the table doesn't look too messy.

>eat breakfast
You have gotten everything you wanted from the breakfast dishes.

>take breakfast
You have gotten everything you wanted from the breakfast dishes.

>stand on table
You ease onto one of the table's benches.

The Land of Breakfast and Lunch (on the painted picnic table)
The Land of Breakfast and Lunch is a lot smaller than you were expecting.  It's actually just a small clearing near the road, like a roadside stop, with a painted picnic table containing the empty dishes from a simple but nourishing breakfast on one end, and a simple but nourishing lunch on the other end.  A stubby little path leads backwards, and the path continues forward, towards The Land of Unrealized Possibilities.  If you "walk forward" or just "forward" or even just "f" you will be walking towards it.

On the painted picnic table you can see Lunch.

>get up
You get off the painted picnic table.

The Land of Breakfast and Lunch
The Land of Breakfast and Lunch is a lot smaller than you were expecting.  It's actually just a small clearing near the road, like a roadside stop, with a painted picnic table containing the empty dishes from a simple but nourishing breakfast on one end, and a simple but nourishing lunch on the other end.  A stubby little path leads backwards, and the path continues forward, towards The Land of Unrealized Possibilities.  If you "walk forward" or just "forward" or even just "f" you will be walking towards it.

You can see a painted picnic table (on which is Lunch) here.

* * *

>eat breakfast
(Breakfast)
You sit down for a moment and eat breakfast.  It is delicious but you still don't quite feel satisfied.

>look egg
You can't see any such thing.

* * *

>f
Hopeful Path
You are on the hopeful path.  Backwards from here is The Land of Breakfast and Lunch.  Forward is The Land of Unrealized Possibilities.

I beg your pardon?

>f
The Land of Unrealized Possibilities
You are in the Land of Unrealized Possibilities.  Just being here gives you a sense of all that could be accomplished if enough time, effort, and focus were pointed in a specific direction.  There is a sense of both excitement and disappointment here that is almost palpable.  The Hopeful Path leads backward towards The Land of Breakfast and Lunch, a place with a much clearer sense of purpose.  The Seaside Path leads forward, towards The Land of Unlaunched Vessels.

You can see a toy box (closed), a couch (on which is your brother), and a TV here.

I beg your pardon?

>f
Seaside Path
You are on the seaside path.  Backwards from here is The Land of Unrealized Possibilities.  Forward is The Land of Unlaunched Vessels.

* * *

>f
The Path Around the Liquor Store
You're on the path around the liquor store.  You see the side of the liquor store on one side and a fence on the other side.

I beg your pardon?

>b
The Land Behind the Liquor Store
You are in The Land Behind the Liquor Store.  It's underwhelming.  You've got your standard collection of broken down boxes, a dumpster, and a stack of pallets.  Behind you, the anticlimactic path leads to The Land of Unlaunched Vessels II: The Launchening.  Ahead of you, The Path Around the Liquor Store leads to The Land in Front of the Liquor Store.

>look
The Land Behind the Liquor Store
You are in The Land Behind the Liquor Store.  It's underwhelming.  You've got your standard collection of broken down boxes, a dumpster, and a stack of pallets.  Behind you, the anticlimactic path leads to The Land of Unlaunched Vessels II: The Launchening.  Ahead of you, The Path Around the Liquor Store leads to The Land in Front of the Liquor Store.

>get dumpster
There's nothing back behind the liquor store you need or want to carry around.

>get pallets
There's nothing back behind the liquor store you need or want to carry around.

>get boxes
There's nothing back behind the liquor store you need or want to carry around.

* * *

>f
Hopeful Path
You are on the hopeful path.  Backwards from here is The Land of Breakfast and Lunch.  Forward is The Land of Unrealized Possibilities.

>ask brother about box
You can't see any such thing.

>f
The Land of Unrealized Possibilities
You are in the Land of Unrealized Possibilities.  Just being here gives you a sense of all that could be accomplished if enough time, effort, and focus were pointed in a specific direction.  There is a sense of both excitement and disappointment here that is almost palpable.  The Hopeful Path leads backward towards The Land of Breakfast and Lunch, a place with a much clearer sense of purpose.  The Seaside Path leads forward, towards The Land of Unlaunched Vessels.

You can see a toy box (closed), a couch (on which is your brother), and a TV here.

>ask brother about penny
Yeah, it's , snotball, what do you want from me?

>ask brother about box
Yeah, it's , snotball, what do you want from me?

>ask brother about monkey
Yeah, it's , snotball, what do you want from me?

* * *

>f
Hopeful Path
You are on the hopeful path.  Backwards from here is The Land of Breakfast and Lunch.  Forward is The Land of Unrealized Possibilities.

>b
The Land of Breakfast and Lunch
The Land of Breakfast and Lunch is a lot smaller than you were expecting.  It's actually just a small clearing near the road, like a roadside stop, with a painted picnic table containing a simple but nourishing breakfast on one end, and a simple but nourishing lunch on the other end.  A stubby little path leads backwards, and the path continues forward, towards The Land of Unrealized Possibilities.  If you "walk forward" or just "forward" or even just "f" you will be walking towards it.

You can see a painted picnic table (on which are Breakfast and Lunch) here.

>eat breakfast
(Breakfast)
You sit down for a moment and eat breakfast.  It is delicious but you still don't quite feel satisfied.

* * *

>f
Hopeful Path
You are on the hopeful path.  Backwards from here is The Land of Breakfast and Lunch.  Forward is The Land of Unrealized Possibilities.

>f
The Land of Unrealized Possibilities
You are in the Land of Unrealized Possibilities.  Just being here gives you a sense of all that could be accomplished if enough time, effort, and focus were pointed in a specific direction.  There is an sense of both excitement and disappointment here that is almost palpable.  The Hopeful Path leads backward towards The Land of Breakfast and Lunch, a place with a much clearer sense of purpose.

You can see a toy box (closed), a couch (on which is your brother), and a TV here.

>f
Seaside Path
You are on the the seaside path.  Backwards from here is The Land of Unrealized Possibilities.  Forward is The Land of Unlaunched Vessels.

>f
The Land of Unlaunched Vessels
You are in the The Land of Unlaunched Vessels.  You stand near the edge of the bay, and there is a vessel moored here with thick and aged ropes tied to a bollard.  The Hopeful Path leads backward towards The Land of Unrealized Possibilities, a place you're not sure you want to be.  Forward, Sequel Path leads to The Land of Unlaunched Vessels II: The Launchening.

You can see an a swarthy hippie seaperson here.

>f
Sequel Path
You are on the the sequel path.  Backwards from here is The Land of Unlaunched Vessels.  Forward is The Land of Unlaunched Vessels II: The Launchening.

>f
The Land of Unlaunched Vessels II: The Launchening
You are in The Land of Unlaunched Vessels II: The Launchening.  There is a launchpad here, on which sits a large, 1950's era rocket in galaxy white and candy-apple red. Sequel Path leads backwards towards The Land of Unlaunched Vessels

You can see a launchpad and a Rocket here.

>open hatch
You open the hatch.

>climb ladder
You pull yourself into the rocket.

The Inside of the Parked Rocket
You are within the smooth walls of the rocket.  It is very plain here, out the porthole window you can see The Land of Unlaunched Vessels II: The Launchening.

You can see a the cockpit, a big metal unit containing a captain's chair and a control panel here.

>press red button
The rocket launches and then takes off. @TODO.

The Deep, Dark Void of Space
You are inside the rocket as it cruises very slowly through the deep, dark void of space.  Outside the porthole window you see the deep, dark void of space covered over with a curtain of stars.

The the cockpit, a big metal unit containing a captain's chair and a control panel is here.

>look window
You can't see any such thing.

>look porthole
You can't see any such thing.

>press forward
Whoosh. @TODO.

Elbow Nebula
You are inside the rocket as it cruises very slowly through the deep, dark void of space.  Outside the porthole window you see the deep, dark void of space covered over with a curtain of stars.

The the cockpit, a big metal unit containing a captain's chair and a control panel is here.

You notice something unusual outside the porthole window.

>look porthole
There is a giant space jellyfish made of light here.  Ok, it's not really a jellyfish, but that's the closest thing you can think of to call it.  @TODO Behind it is a curtain of stars.

>look window
There is a giant space jellyfish made of light here.  Ok, it's not really a jellyfish, but that's the closest thing you can think of to call it.  @TODO Behind it is a curtain of stars.

>press return button
The rocket shifts through space, and returns home to the launchpad. @TODO.

The Inside of the Parked Rocket
You are within the smooth walls of the rocket.  It is very plain here, out the porthole window you can see The Land of Launched Vessels.

* * *

>f
The Land of Unrealized Possibilities
You are in the Land of Unrealized Possibilities.  Just being here gives you a sense of all that could be accomplished if enough time, effort, and focus were pointed in a specific direction.  There is an sense of both excitement and disappointment here that is almost palpable.  The Hopeful Path leads backward towards The Land of Breakfast and Lunch, a place with a much clearer sense of purpose.

You can see a toy box (closed), a couch (on which is your brother), and a TV here.

>open box
You open the toy box, revealing a wooden block, a skinny naked plastic doll, a closed jack-in-the-box, a lite-brite, a coloring book, a small heart shaped locket, and a small hobby horse.

>get jack-in-the-box
Taken.

>f
Seaside Path
You are on the the seaside path.  Backwards from here is The Land of Unrealized Possibilities.  Forward is The Land of Unlaunched Vessels.

>f
The Land of Unlaunched Vessels
You are in the The Land of Unlaunched Vessels.  You stand near the edge of the bay, and there is a vessel moored here with thick and aged ropes tied to a bollard.  The Hopeful Path leads backward towards The Land of Unrealized Possibilities, a place you're not sure you want to be.  Forward, Sequel Path leads to The Land of Unlaunched Vessels II: The Launchening.

You can see a kiddie ride and an a swarthy hippie seaperson here.

>f
Sequel Path
You are on the the sequel path.  Backwards from here is The Land of Unlaunched Vessels.  Forward is The Land of Unlaunched Vessels II: The Launchening.

* * *

>open hatch
You open the hatch.

>climb ladder
You pull yourself into the rocket.

The Inside of the Parked Rocket
You are within the smooth walls of the rocket.  It is very plain here, out the porthole window you can see the sky, and out the hatch you can see The Land of Unlaunched Vessels II: The Launchening.

You can see a the cockpit, a big metal unit containing a captain's chair and a control panel here.

>press red
It's natural to expect blastoff immediately.  Instead, the hatch door whirrs slowly shut, coming to a solid clang.  You have just enough time to realize that you could buckle yourself into the captain's chair and you do.  Just in time, as you feel a tremendous slow and steady thrust of force wrap itself around you as the sky begins to move in the porthole window.  For just one moment you swear you can see The Land of Breakfast and Lunch streak by the window.  Finally, the sky begins to darken, and all sound becomes only a vibration.  The deep, dark void of space is with you.  You absentmindedly unbuckle the webbing securing you to the seat, and you feel free to move about the interior.

The Deep, Dark Void of Space
You are inside the rocket as it cruises very slowly through the deep, dark void of space.  Outside the porthole window is the deep, dark void of space covered over with a curtain of stars.

>press blue
Whoosh.  You thought maybe the engine engaged again, but something else already did.  It bent space softly around you, and, maybe the rocket moved a little.  Like with a soft whoosh.  It happened in less than a second.  Now, you think you're somewhere else.

Kamiro Quadrant
You are inside the rocket as it cruises very slowly through the deep, dark void of space.  Outside the porthole window is the deep, dark void of space covered over with a curtain of stars.

You notice something unusual outside the porthole window.

>knock window
Violence isn't the answer to this one.

>hit window
Violence isn't the answer to this one.

>turn crank
You grasp the little wooden ball and begin to turn the crank as you hold the jack-in-the-box steady.  A dark little tune plinks its way out, echoing forth from the little tin box.  It's not "all around the mulberry bush" or any song you recognize, so you don't quite expect it when its last note ends, and the spring-loaded doll within leaps out with surprising agility.  You jump a tiny bit, in spite of yourself.  The devil doll looks pleased.

>press blue
Whoosh.  You thought maybe the engine engaged again, but something else already did.  It bent space softly around you, and, maybe the rocket moved a little.  Like with a soft whoosh.  It happened in less than a second.  Now, you think you're somewhere else.

Kamiro Quadrant
You are inside the rocket as it cruises very slowly through the deep, dark void of space.  Outside the porthole window is the deep, dark void of space covered over with a curtain of stars.

You notice something unusual outside the porthole window.

You can see a the cockpit, a big metal unit containing a captain's chair and a control panel here.

>turn crank
You can turn the crank, but the jack-in-the-box is already out-of-the-box.

>close jack-in-the-box
(the open jack-in-the-box)
You shove the devil doll into the body of the box, and shut the lid with a satisfying snap.

>turn crank
You grasp the little wooden ball and begin to turn the crank as you hold the jack-in-the-box steady.  A dark little tune plinks its way out, echoing forth from the little tin box.  It's not "all around the mulberry bush" or any song you recognize, so you don't quite expect it when its last note ends, and the spring-loaded doll within leaps out with surprising agility.  You jump a tiny bit, in spite of yourself.  The devil doll looks pleased.

>press blue
Whoosh.  You thought maybe the engine engaged again, but something else already did.  It bent space softly around you, and, maybe the rocket moved a little.  Like with a soft whoosh.  It happened in less than a second.  Now, you think you're somewhere else.

Chrysocolla Cluster
You are inside the rocket as it cruises very slowly through the deep, dark void of space.  Outside the porthole window is the deep, dark void of space covered over with a curtain of stars.

You notice something unusual outside the porthole window.

>turn crank
You can turn the crank, but the jack-in-the-box is already out-of-the-box.

* * *

>close jack-in-the-box
(the open jack-in-the-box)
You shove the devil doll into the body of the box, and shut the lid with a satisfying snap.

>turn crank
You grasp the little wooden ball and begin to turn the crank as you hold the jack-in-the-box steady.  A dark little tune plinks its way out, echoing forth from the little tin box.  It's not "all around the mulberry bush" or any song you recognize, so you don't quite expect it when its last note ends, and the spring-loaded doll within leaps out with surprising agility.  You jump a tiny bit, in spite of yourself.  The devil doll looks pleased.

You startle the simian businessperson and they lose their concentration for one moment.  Their fingers whip forward towards you involuntarily, and you suddenly feel whatever they were holding in the palm of your own hand.  It is a shiny 1964 quarter.  The businessperson looks briefly dismayed but merely pulls something else out of its pocket.

>close jack-in-the-box
(the open jack-in-the-box)
You shove the devil doll into the body of the box, and shut the lid with a satisfying snap.

>turn crank
You grasp the little wooden ball and begin to turn the crank as you hold the jack-in-the-box steady.  A dark little tune plinks its way out, echoing forth from the little tin box.  It's not "all around the mulberry bush" or any song you recognize, so you don't quite expect it when its last note ends, and the spring-loaded doll within leaps out with surprising agility.  You jump a tiny bit, in spite of yourself.  The devil doll looks pleased.
The simian businessperson's eyes widen in fear, but otherwise he keeps his cool.

>i
You are carrying:
  an open jack-in-the-box
  a shiny 1964 quarter

* * *

>eat lunch
(Lunch)
It doesn't really seem appropriate to just start eating lunch with a perfectly good breakfast sitting there at the same table.  Besides, you're really more in the mood for breakfast.

>>
That's not a verb I recognize.

>n
Hopeful Path
You are on the hopeful path.  Backwards from here is The Land of Breakfast and Lunch.  Forward is The Land of Unrealized Possibilities.

>f
The Land of Unrealized Possibilities
You are in the Land of Unrealized Possibilities.  Just being here gives you a sense of all that could be accomplished if enough time, effort, and focus were pointed in a specific direction.  There is an sense of both excitement and disappointment here that is almost palpable.  The Hopeful Path leads backward towards The Land of Breakfast and Lunch, a place with a much clearer sense of purpose.

You can see a toy box (closed), a couch (on which is your brother), and a TV here.

>show locket to brother
You can't see any such thing.

>take off locket
You can't see any such thing.

>show locket to brother
You can't see any such thing.

>look locket
You can't see any such thing.

>i
You examine what you'd normally use to carry things, all the way from fingertip to elbow.  As you suspected, nothing is contained there.  You briefly check for pockets or some kind of fanny pack.  There isn't anything like that.  You are forced to conclude that you have no possessions.

>open box
You open the toy box, revealing a wooden block, a small heart shaped locket, and a small hobby horse.

>wear locket
(first taking the small heart shaped locket)
You put on the small heart shaped locket.

>show locket to brother
your brother is unimpressed.

>look under couch
You find nothing of interest.

* * *

>look
The Land of Breakfast and Lunch
The Land of Breakfast and Lunch is a lot smaller than you were expecting.  It's actually just a small clearing near the road, like a roadside stop, with a painted picnic table containing a simple but nourishing breakfast on one end, and a simple but nourishing lunch on the other end.  A stubby little path leads backwards, and the path continues forward, towards The Land of Unrealized Possibilities.  If you "walk forward" or just "forward" or even just "f" you will be walking towards it.

You can see a painted picnic table (on which are Breakfast and Lunch) here.

* * *

>look path
You can't see any such thing.

* * *

>stand on table
Now that's just rude.

>look sun
The sun is a simple yellow circle.

>look trees
The pine trees are just a brown rectangle topped with a jagged green pine tree shape.

>look beams
The sun beams are bright yellow geometric shapes symbolically nourishing the pine trees with their light.

* * *

I beg your pardon?

>f
Seaside Path
You are on the the seaside path.  Backwards from here is The Land of Unrealized Possibilities.  Forward is The Land of Unlaunched Vessels.

I beg your pardon?

>f
The Land of Unlaunched Vessels
You are in the The Land of Unlaunched Vessels.  You stand near the edge of the bay, and there is a vessel moored here with thick and aged ropes tied to a bollard.  The Hopeful Path leads backward towards The Land of Unrealized Possibilities, a place you're not sure you want to be.  Forward, Sequel Path leads to The Land of Unlaunched Vessels II: The Launchening.

You can see a kiddie ride and an a swarthy hippie seaperson here.

I beg your pardon?

>f
Sequel Path
You are on the the sequel path.  Backwards from here is The Land of Unlaunched Vessels.  Forward is The Land of Unlaunched Vessels II: The Launchening.

* * *

>f
The Land of Unlaunched Vessels II: The Launchening
You are in The Land of Unlaunched Vessels II: The Launchening.  There is a launchpad here, on which sits a large, 1950's era rocket in galaxy white and candy-apple red. Sequel Path leads backwards towards The Land of Unlaunched Vessels

You can see a launchpad and a Rocket here.

>enter rocket
The hatch is closed.

>open hatch
You open the hatch.

>enter rocket
You pull yourself into the rocket.

The Inside of the Parked Rocket
You are within the smooth walls of the rocket.  It is very plain here, out the porthole window you can see the sky, and out the hatch you can see The Land of Unlaunched Vessels II: The Launchening.

You can see a the cockpit, a big metal unit containing a captain's chair and a control panel here.

>press red
You're too hungry to go to space.

>restart
Are you sure you want to restart?

>yes
Some would say that life is like a box of metaphors.  I would not say that.  I would say life is a land of metaphors.  You come to this land perhaps from a hidden door in the back of a piece of furniture, perhaps from a door in a dream.  Either way, you find yourself here.

The Land of Breakfast and Lunch
~ a land can contain both ~ by Daniel Talsky
Release 3 / Serial number 200318 / Inform 7 build 6M62 (I6/v6.34 lib 6/12N) SD

The Path
You are at the beginning of a path.  It is plain, even homely.  It leads forward towards The Land of Breakfast and Lunch.  If you "walk forward" you will follow the path.

* * *

>press blue
Whoosh.  You thought maybe the engine engaged again, but something else already did.  It bent space softly around you, and, maybe the rocket moved a little.  Like with a soft whoosh.  It happened in less than a second.  Now, you think you're somewhere else.

Chrysocolla Cluster
You are inside the rocket as it cruises very slowly through the deep, dark void of space.  Outside the porthole window is the deep, dark void of space covered over with a curtain of stars.

You notice something unusual outside the porthole window.

>press blue
Whoosh.  You thought maybe the engine engaged again, but something else already did.  It bent space softly around you, and, maybe the rocket moved a little.  Like with a soft whoosh.  It happened in less than a second.  Now, you think you're somewhere else.

Kamiro Quadrant
You are inside the rocket as it cruises very slowly through the deep, dark void of space.  Outside the porthole window is the deep, dark void of space covered over with a curtain of stars.

You notice something unusual outside the porthole window.

>press red
Launch has occurred and the button is in the fully activated position.

I beg your pardon?

>press blue
Whoosh.  You thought maybe the engine engaged again, but something else already did.  It bent space softly around you, and, maybe the rocket moved a little.  Like with a soft whoosh.  It happened in less than a second.  Now, you think you're somewhere else.

Elbow Nebula
You are inside the rocket as it cruises very slowly through the deep, dark void of space.  Outside the porthole window is the deep, dark void of space covered over with a curtain of stars.

You notice something unusual outside the porthole window.

>press red
Launch has occurred and the button is in the fully activated position.

>press black
Whoosh. At the end of the rocket's soft whoosh, its mighty engines begin to engage, slowing its fall as it pillows down to the landing pad in The Land of Once Launched Vessels.

The Inside of the Parked Rocket
You are within the smooth walls of the rocket.  It is very plain here, out the porthole window you can see the sky, and out the hatch you can see The Land of Once Launched Vessels.

>press red
It's natural to expect blastoff immediately.  Instead, the hatch door whirrs slowly shut, coming to a solid clang.  You have just enough time to realize that you could buckle yourself into the captain's chair and you do.  Just in time, as you feel a tremendous slow and steady thrust of force wrap itself around you as the sky begins to move in the porthole window.  For just one moment you swear you can see The Land of Breakfast and Lunch streak by the window.  Finally, the sky begins to darken, and all sound becomes only a vibration.  The deep, dark void of space is with you.  You absentmindedly unbuckle the webbing securing you to the seat, and you feel free to move about the interior.

The Deep, Dark Void of Space
You are inside the rocket as it cruises very slowly through the deep, dark void of space.  Outside the porthole window is the deep, dark void of space covered over with a curtain of stars.

>press red
Launch has occurred and the button is in the fully activated position.

* * *

>press blue
Whoosh.  You thought maybe the engine engaged again, but something else already did.  It bent space softly around you, and, maybe the rocket moved a little.  Like with a soft whoosh.  It happened in less than a second.  Now, you think you're somewhere else.

Elbow Nebula
You are inside the rocket as it cruises very slowly through the deep, dark void of space.  Outside the porthole window is the deep, dark void of space covered over with a curtain of stars.

You notice something unusual outside the porthole window.

I beg your pardon?

>look
Chrysocolla Cluster
You are inside the rocket as it cruises very slowly through the deep, dark void of space.  Outside the porthole window is the deep, dark void of space covered over with a curtain of stars.

You notice something unusual outside the porthole window.

You can see a the cockpit, a big metal unit containing a captain's chair and a control panel here.

>look porthole
Just outside the window is a simian businessperson, with a tidy leather jetpack.  Behind them is a curtain of stars.

>press red
Launch has occurred and the button is in the fully activated position.

>press blue
Whoosh.  You thought maybe the engine engaged again, but something else already did.  It bent space softly around you, and, maybe the rocket moved a little.  Like with a soft whoosh.  It happened in less than a second.  Now, you think you're somewhere else.

Chrysocolla Cluster
You are inside the rocket as it cruises very slowly through the deep, dark void of space.  Outside the porthole window is the deep, dark void of space covered over with a curtain of stars.

You notice something unusual outside the porthole window.

You can see a the cockpit, a big metal unit containing a captain's chair and a control panel here.

>look
Chrysocolla Cluster
You are inside the rocket as it cruises very slowly through the deep, dark void of space.  Outside the porthole window is the deep, dark void of space covered over with a curtain of stars.

You notice something unusual outside the porthole window.

You can see a the cockpit, a big metal unit containing a captain's chair and a control panel here.

* * *

>look porthole
Just outside the window is a simian businessperson, with a tidy leather jetpack.  Behind them is a curtain of stars.

>press blue
Whoosh.  You thought maybe the engine engaged again, but something else already did.  It bent space softly around you, and, maybe the rocket moved a little.  Like with a soft whoosh.  It happened in less than a second.  Now, you think you're somewhere else.

Chrysocolla Cluster
You are inside the rocket as it cruises very slowly through the deep, dark void of space.  Outside the porthole window is the deep, dark void of space covered over with a curtain of stars.

You notice something unusual outside the porthole window.

You can see a the cockpit, a big metal unit containing a captain's chair and a control panel here.

>press blue
Whoosh.  You thought maybe the engine engaged again, but something else already did.  It bent space softly around you, and, maybe the rocket moved a little.  Like with a soft whoosh.  It happened in less than a second.  Now, you think you're somewhere else.

Kamiro Quadrant
You are inside the rocket as it cruises very slowly through the deep, dark void of space.  Outside the porthole window is the deep, dark void of space covered over with a curtain of stars.

You notice something unusual outside the porthole window.

>look businessperson
You can't see any such thing.

>kick glass
I only understood you as far as wanting to kick.

>punch glass
You can't see any such thing.

>press land
You can't see any such thing.

>look panel
The control panel is an extremely austere, some might even say naive set of controls.  There is a large, shiny, red button labeled "Launch", a smaller black button that labeled "Return", and then off to your right, a medium-sized bright blue button labeled "Forward".  Finally, along the top is a small LED readout display that says "Kamiro Quadrant".

That's it.  Surely you should be able to operate a spacecraft with only those controls?  (You look on the front for a button marked "Fire Laser" or "Warp 7" but those buttons are not on the control panel or anywhere else inside the ship.)

>press black
Whoosh. At the end of the rocket's soft whoosh, its mighty engines begin to engage, slowing its fall as it pillows down to the landing pad in The Land of Twice Launched Vessels.

The Inside of the Parked Rocket
You are within the smooth walls of the rocket.  It is very plain here, out the porthole window you can see the sky, and out the hatch you can see The Land of Twice Launched Vessels.

>get out
You exit the hatch opening and climb to the ground.

The Land of Twice Launched Vessels
You are in The Land of Twice Launched Vessels.  There is a launchpad here, on which sits a large, 1950's era rocket in galaxy white and candy-apple red. The Spiritual Sequel Path leads backwards towards The Land of Unlaunched Vessels

You can see a launchpad and a Rocket here.

>s
The Spiritual Sequel Path
You are on the the sequel path.  Backwards from here is The Land of Unlaunched Vessels.  Forward is The Land of Twice Launched Vessels.

>s
The Land of Unlaunched Vessels
You are in the The Land of Unlaunched Vessels.  You stand near the edge of the bay, and there is a vessel moored here with thick and aged ropes tied to a bollard.  The Hopeful Path leads backward towards The Land of Unrealized Possibilities, a place you're not sure you want to be.  Forward, The Spiritual Sequel Path leads to The Land of Twice Launched Vessels.

You can see a kiddie ride and an a swarthy hippie seaperson here.

>look kiddie ride
Off to the side a little ways is a mechanical kiddie ride.  It's a big (to a child) yellow humvee with cartoon human eyes where the headlights should be.  It's anchored to a diamond plate platform and looks to have stopped mid-tilt.

Mounted on a post next to it is a coin box showing the coin denomination necessary to make it run: 25, or one U.S. quarter dollar piece.

There were once two of these rides outside every grocery store in America.  Whether they died out because kids collectively realized they weren't fun, or just liability, you're surprised to see this one here.

The kiddie ride is currently switched off.

>put quarter in kiddie ride
You can't see any such thing.

>put quarter in slot
You can't see any such thing.

>ride humvee
You climb up on the molded fiberglass seat of the humvee but it feels cold, joyless, and dead underneath you.  You distinctly feel the feeling of being so unloved that no one would put a quarter in the slot, not understanding how such a simple thing could make all the difference.  You slide slowly off.

>switch on kiddie ride
You switch the kiddie ride on.

>switch the kiddie ride off
You switch the kiddie ride off.

>switch the kiddie ride on
You switch the kiddie ride on.

>ride kiddie ride
You climb up on the molded fiberglass seat of the humvee like a pro and right yourself against its tame rollicking.  At first you find it boring, but you quickly get in the spirit, facetiously adjusting your imaginary cowboy hat and making a quick lasso motion with your wrist to show the yellow humvee you're in full control, despite its raucous bucking.

If this was what you were trying to do, you pretty much won the game.  If you still have more to do, go ahead.

>switch the kiddie ride off
That's already off.

>i
You examine what you'd normally use to carry things, all the way from fingertip to elbow.  As you suspected, nothing is contained there.  You briefly check for pockets or some kind of fanny pack.  There isn't anything like that.  You are forced to conclude that you have no possessions.

* * *

>press blue
Whoosh.  You thought maybe the engine engaged again, but something else already did.  It bent space softly around you, and, maybe the rocket moved a little.  Like with a soft whoosh.  It happened in less than a second.  Now, you think you're somewhere else.

Elbow Nebula
You are inside the rocket as it cruises very slowly through the deep, dark void of space.  Outside the porthole window is the deep, dark void of space covered over with a curtain of stars.

You notice something unusual outside the porthole window.

>look
Elbow Nebula
You are inside the rocket as it cruises very slowly through the deep, dark void of space.  Outside the porthole window is the deep, dark void of space covered over with a curtain of stars.

You notice something unusual outside the porthole window.

You can see a the cockpit, a big metal unit containing a captain's chair and a control panel here.

>look porthole
There is a giant space jellyfish made of light here.  Ok, it's not really a jellyfish, but that's the closest thing you can think of to call it.  Behind it is a curtain of stars.

>press red
Launch has occurred and the button is in the fully activated position.

>press blue
Whoosh.  You thought maybe the engine engaged again, but something else already did.  It bent space softly around you, and, maybe the rocket moved a little.  Like with a soft whoosh.  It happened in less than a second.  Now, you think you're somewhere else.

Kamiro Quadrant
You are inside the rocket as it cruises very slowly through the deep, dark void of space.  Outside the porthole window is the deep, dark void of space covered over with a curtain of stars.

You notice something unusual outside the porthole window.

>look
Kamiro Quadrant
You are inside the rocket as it cruises very slowly through the deep, dark void of space.  Outside the porthole window is the deep, dark void of space covered over with a curtain of stars.

You notice something unusual outside the porthole window.

You can see a the cockpit, a big metal unit containing a captain's chair and a control panel here.

>look porthole
There is a space station here, as crisp and clean in the near distance as 1960"s motion picture film.  It's a wheel with four little crossbars connecting its two tubular circles.  It's dotted with windows and tiny devices you can't see clearly from here.  A few lights pulse on the surface from time to time.  Its surface is almost blindingly white and clean.  It is very well lit.  Behind it is a curtain of stars.

>press blue
Whoosh.  You thought maybe the engine engaged again, but something else already did.  It bent space softly around you, and, maybe the rocket moved a little.  Like with a soft whoosh.  It happened in less than a second.  Now, you think you're somewhere else.

Elbow Nebula
You are inside the rocket as it cruises very slowly through the deep, dark void of space.  Outside the porthole window is the deep, dark void of space covered over with a curtain of stars.

You notice something unusual outside the porthole window.

>press blue
Whoosh.  You thought maybe the engine engaged again, but something else already did.  It bent space softly around you, and, maybe the rocket moved a little.  Like with a soft whoosh.  It happened in less than a second.  Now, you think you're somewhere else.

Chrysocolla Cluster
You are inside the rocket as it cruises very slowly through the deep, dark void of space.  Outside the porthole window is the deep, dark void of space covered over with a curtain of stars.

You notice something unusual outside the porthole window.

>look businessperson
The simian businessperson looks like they could be a human or monkey, but with elaborate stage makeup.  Their fur is a pale pink, and they have an oddly shaped skull.  You think "businessperson", because of the exquisitely tailored suit of clothes.  The simian is just floating softly in space, as if killing time while waiting for a bus, fidgeting with eight-fingered, pink hands.  Paws.  You can't quite see what it is, but the simian is spinning some very small object in its fingers.

>kick glass
I only understood you as far as wanting to kick.

>punch glass
You startle the simian businessperson and they lose their concentration for one moment.  Their fingers whip forward towards you involuntarily, and you suddenly feel whatever they were holding in the palm of your own hand.  It is a shiny 1964 quarter.  The businessperson looks briefly dismayed but merely pulls something else out of its pocket.

>press land
You can't see any such thing.

>look panel
The control panel is an extremely austere, some might even say naive set of controls.  There is a large, shiny, red button labeled "Launch", a smaller black button that labeled "Return", and then off to your right, a medium-sized bright blue button labeled "Forward".  Finally, along the top is a small LED readout display that says "Chrysocolla Cluster".

That's it.  Surely you should be able to operate a spacecraft with only those controls?  (You look on the front for a button marked "Fire Laser" or "Warp 7" but those buttons are not on the control panel or anywhere else inside the ship.)

>press black
Whoosh. At the end of the rocket's soft whoosh, its mighty engines begin to engage, slowing its fall as it pillows down to the landing pad in The Land of Twice Launched Vessels.

The Inside of the Parked Rocket
You are within the smooth walls of the rocket.  It is very plain here, out the porthole window you can see the sky, and out the hatch you can see The Land of Twice Launched Vessels.

* * *

>put quarter in kiddie ride
That can't contain things.

>put quarter in slot
Gravity pulls the quarter down into the slot, and then there is an agonizing pause before the weight of the quarter trips an internal lever in the machine and its song comes to life.  50% speed in one second, full speed at two seconds.  The song is "In my merry Oldsmobile" and the dance of the humvee is drunken yet tame as it rolls and lists in a pattern potentially thrilling to a 3-year old but usually not really.  If you want to, you can ride the humvee now.

>ride humvee
You climb up on the molded fiberglass seat of the humvee but it feels cold, joyless, and dead underneath you.  You distinctly feel the feeling of being so unloved that no one would put a quarter in the slot, not understanding how such a simple thing could make all the difference.  You slide slowly off.

* * *

>f
The Land of Unrealized Possibilities
You are in the Land of Unrealized Possibilities.  Just being here gives you a sense of all that could be accomplished if enough time, effort, and focus were pointed in a specific direction.  There is a sense of both excitement and disappointment here that is almost palpable.  The Hopeful Path leads backward towards The Land of Breakfast and Lunch, a place with a much clearer sense of purpose.  The Seaside Path leads forward, towards The Land of Unlaunched Vessels.

You can see a toy box (closed), a couch (on which is your brother), and a TV here.

>ask brother about box
Yeah, it's your brother, snotball, what do you want from me?

* * *

>f
The Land of Unrealized Possibilities
You are in the Land of Unrealized Possibilities.  Just being here gives you a sense of all that could be accomplished if enough time, effort, and focus were pointed in a specific direction.  There is a sense of both excitement and disappointment here that is almost palpable.  The Hopeful Path leads backward towards The Land of Breakfast and Lunch, a place with a much clearer sense of purpose.  The Seaside Path leads forward, towards The Land of Unlaunched Vessels.

You can see a toy box (closed), a couch (on which is your brother), and a TV here.

>ask brother about quarter
"I don't have a quarter, no, but I think there's a penny under the couch."

>ask brother about quarters
"I don't have a quarter, no, but I think there's a penny under the couch."

>tell brother about rocket
"You expect me to believe you saw a real rocket?"

>talk to brother
To start a conversation, try to ASK your brother ABOUT something or TELL your brother ABOUT something.

* * *

>f
The Land of Unrealized Possibilities
You are in the Land of Unrealized Possibilities.  Just being here gives you a sense of all that could be accomplished if enough time, effort, and focus were pointed in a specific direction.  There is a sense of both excitement and disappointment here that is almost palpable.  The Hopeful Path leads backward towards The Land of Breakfast and Lunch, a place with a much clearer sense of purpose.  The Seaside Path leads forward, towards The Land of Unlaunched Vessels.

You can see a toy box (closed), a couch (on which is your brother), and a TV here.

>attack brother
Violence isn't the answer to this one.

* * *

>f
The Land of Unrealized Possibilities
You are in the Land of Unrealized Possibilities.  Just being here gives you a sense of all that could be accomplished if enough time, effort, and focus were pointed in a specific direction.  There is a sense of both excitement and disappointment here that is almost palpable.  The Hopeful Path leads backward towards The Land of Breakfast and Lunch, a place with a much clearer sense of purpose.  The Seaside Path leads forward, towards The Land of Unlaunched Vessels.

You can see a toy box (closed), a couch (on which is your brother), and a TV here.

>brother, jump
"Does it look like I'm taking orders from you?  Reminder: you are a giant loser."

>brother, walk
You'll have to say which compass direction to go in.
I didn't understand that instruction.

>brother, walk north
Your brother has better things to do.

* * *

>f
The Land of Unrealized Possibilities
You are in the Land of Unrealized Possibilities.  Just being here gives you a sense of all that could be accomplished if enough time, effort, and focus were pointed in a specific direction.  There is a sense of both excitement and disappointment here that is almost palpable.  The Hopeful Path leads backward towards The Land of Breakfast and Lunch, a place with a much clearer sense of purpose.  The Seaside Path leads forward, towards The Land of Unlaunched Vessels.

You can see a toy box (closed), a couch (on which is your brother), and a TV here.

>brother, walk north
"Does it look like I'm taking orders from you?  A little reminder: you are a giant loser."

* * *

>f
The Land of Unrealized Possibilities
You are in the Land of Unrealized Possibilities.  Just being here gives you a sense of all that could be accomplished if enough time, effort, and focus were pointed in a specific direction.  There is a sense of both excitement and disappointment here that is almost palpable.  The Hopeful Path leads backward towards The Land of Breakfast and Lunch, a place with a much clearer sense of purpose.  The Seaside Path leads forward, towards The Land of Unlaunched Vessels.

You can see a toy box (closed), a couch (on which is your brother), and a TV here.

>change the channel
That's not a verb I recognize.

* * *

>f
The Land of Unrealized Possibilities
You are in the Land of Unrealized Possibilities.  Just being here gives you a sense of all that could be accomplished if enough time, effort, and focus were pointed in a specific direction.  There is a sense of both excitement and disappointment here that is almost palpable.  The Hopeful Path leads backward towards The Land of Breakfast and Lunch, a place with a much clearer sense of purpose.  The Seaside Path leads forward, towards The Land of Unlaunched Vessels.

You can see a toy box (closed), a couch (on which is your brother), and a TV here.

>change tv
"C'mon, Farts McJohnson," your brother says, wearily, "I'm watching this."

>change tv
"Hey, I've got an idea.  Why not find literally any other way to entertain yourself."

>change tv
"Look, I know it's the God-given job of a little sibling to mar the TV-watching experience, but if you could give it a rest, I'd really appreciate it."

>change tv
"Ugh.  Stop."

>change tv
"Ugh.  Stop."

>talk to brother
To start a conversation, try to ASK your brother ABOUT something or TELL your brother ABOUT something.

>ask brother about brother
"Yes, I'm your brother.  I am watching TV.  You are mentally challenged.  You are annoying me."

>ask brother about me
"It's yourself, just look at it yourself."

* * *

>f
The Land of Unrealized Possibilities
You are in the Land of Unrealized Possibilities.  Just being here gives you a sense of all that could be accomplished if enough time, effort, and focus were pointed in a specific direction.  There is a sense of both excitement and disappointment here that is almost palpable.  The Hopeful Path leads backward towards The Land of Breakfast and Lunch, a place with a much clearer sense of purpose.  The Seaside Path leads forward, towards The Land of Unlaunched Vessels.

You can see a toy box (closed), a couch (on which is your brother), and a TV here.

>eat lunch
You can't see any such thing.

>b
Hopeful Path
You are on the hopeful path.  Backwards from here is The Land of Breakfast and Lunch.  Forward is The Land of Unrealized Possibilities.

>b
The Land of Breakfast and Lunch
The Land of Breakfast and Lunch is a lot smaller than you were expecting.  It's actually just a small clearing near the road, like a roadside stop, with a painted picnic table containing a simple but nourishing breakfast on one end, and a simple but nourishing lunch on the other end.  A stubby little path leads backwards, and the path continues forward, towards The Land of Unrealized Possibilities.  If you "walk forward" or just "forward" or even just "f" you will be walking towards it.

You can see a painted picnic table (on which are Breakfast and Lunch) here.

* * *

>f
Seaside Path
You are on the seaside path.  Backwards from here is The Land of Unrealized Possibilities.  Forward is The Land of Unlaunched Vessels.

I beg your pardon?

>f
The Land of Unlaunched Vessels
You are in The Land of Unlaunched Vessels.  You stand near the edge of the bay, and there is a sailing ship moored here with thick and aged ropes tied to a bollard.  The Hopeful Path leads backward towards The Land of Unrealized Possibilities, a place you're not sure you want to be.  Forward, Sequel Path leads to The Land of Unlaunched Vessels II: The Launchening.

You can see a swarthy hippie seaperson here.

>wave
You wave.

>wave at seaperson
The seaperson gives you a bit of a funny look and hesitantly waves back.  "Hey there," she says.

>s
Seaside Path
You are on the seaside path.  Backwards from here is The Land of Unrealized Possibilities.  Forward is The Land of Unlaunched Vessels.

* * *

>f
Seaside Path
You are on the seaside path.  Backwards from here is The Land of Unrealized Possibilities.  Forward is The Land of Unlaunched Vessels.

>b
The Land of Unrealized Possibilities
You are in the Land of Unrealized Possibilities.  Just being here gives you a sense of all that could be accomplished if enough time, effort, and focus were pointed in a specific direction.  There is a sense of both excitement and disappointment here that is almost palpable.  The Hopeful Path leads backward towards The Land of Breakfast and Lunch, a place with a much clearer sense of purpose.

You can see a toy box (closed), a couch (on which is your brother), and a TV here.

>look
The Land of Unrealized Possibilities
You are in the Land of Unrealized Possibilities.  Just being here gives you a sense of all that could be accomplished if enough time, effort, and focus were pointed in a specific direction.  There is a sense of both excitement and disappointment here that is almost palpable.  The Hopeful Path leads backward towards The Land of Breakfast and Lunch, a place with a much clearer sense of purpose.

You can see a toy box (closed), a couch (on which is your brother), and a TV here.

>open box
You open the toy box, revealing a wooden block, a skinny naked plastic doll, a closed jack-in-the-box, a lite-brite, a coloring book, a small heart shaped locket, and a small hobby horse.

>get locket
Taken.

>open locket
You open the small heart shaped locket, revealing a faded picture of a child who looks a lot like you.

>x locket
It is a small pewter locket.  It looks a bit old fashioned.  The locket has been opened on its tiny hinge.

In the small heart shaped locket is a faded picture of a child who looks a lot like you.

>x clasp
It is a small pewter locket.  It looks a bit old fashioned.  The locket has been opened on its tiny hinge.

In the small heart shaped locket is a faded picture of a child who looks a lot like you.

* * *

>b
The Land of Unrealized Possibilities
You are in the Land of Unrealized Possibilities.  Just being here gives you a sense of all that could be accomplished if enough time, effort, and focus were pointed in a specific direction.  There is a sense of both excitement and disappointment here that is almost palpable.  The Hopeful Path leads backward towards The Land of Breakfast and Lunch, a place with a much clearer sense of purpose.

You can see a toy box (closed), a couch (on which is your brother), and a TV here.

>open box
You open the toy box, revealing a wooden block, a skinny naked plastic doll, a closed jack-in-the-box, a lite-brite, a coloring book, a small heart shaped locket, and a small hobby horse.

>get lite
Taken.

>look cord
It's a black power cord with ungrounded U.S. prongs.

>look prongs
They are ungrounded.

>x prongs
They are ungrounded.

* * *

>f
The Land of Unlaunched Vessels
You are in The Land of Unlaunched Vessels.  You stand near the edge of the bay, and there is a sailing ship moored here with thick and aged ropes tied to a bollard.  The Hopeful Path leads backward towards The Land of Unrealized Possibilities, a place you're not sure you want to be.  Forward, Sequel Path leads to The Land of Unlaunched Vessels II: The Launchening.

You can see a swarthy hippie seaperson here.

>ask hippie about ball
"Oh, you want the tennis ball?  Hey, that seems reasonable."

The seaperson puts both fingers in her mouth and emits an incredibly loud and shrill whistle.  A crewmember pops his head over the edge of the deck and she gives him a little nod.  A few minutes later, he appears at the retaining wall with a large rowboat.

The seaperson hops in, and they row around to the opposite side of the fluyt.  Several minutes later, you see the hippie seaperson doggedly climbing the mast to get to the tennis ball.  It takes her quite a few minutes to get it pulled free from however it's attached to the mast.

Finally, she's rowed back to the retaining wall and she returns to you, deeply panting.  "Here you go," she says wearily, "I hope you find some good use for it."

* * *

>f
The Land of Unlaunched Vessels
You are in The Land of Unlaunched Vessels.  You stand near the edge of the bay, and there is a sailing ship moored here with thick and aged ropes tied to a bollard.  The Hopeful Path leads backward towards The Land of Unrealized Possibilities, a place you're not sure you want to be.  Forward, Sequel Path leads to The Land of Unlaunched Vessels II: The Launchening.

You can see a swarthy hippie seaperson here.

>ask seaperson about bal
"Sorry, I do not know about that."

>ask seaperson about ball
"Oh, you want the tennis ball?  Hey, that seems reasonable."

The seaperson puts both fingers in her mouth and emits an incredibly loud and shrill whistle.  A crewmember pops his head over the edge of the deck and she gives him a little nod.  A few minutes later, he appears at the retaining wall with a large rowboat.

The seaperson hops in, and they row around to the opposite side of the fluyt.  Several minutes later, you see the hippie seaperson doggedly climbing the mast to get to the tennis ball.  It takes her quite a few minutes to get it pulled free from however it's attached to the mast.

Finally, she's rowed back to the retaining wall and she returns to you, panting deeply.  "Here you go," she says wearily, "I hope you find some good use for it."

>g
"I hope you found a good use for it."

>i
You are carrying:
  a tennis ball

* * *

>f
The Land of Unlaunched Vessels II: The Launchening
You are in The Land of Unlaunched Vessels II: The Launchening.  There is a launchpad here, on which sits a large, 1950's era rocket in galaxy white and candy-apple red. The Sequel Path leads backwards towards The Land of Unlaunched Vessels.  Ahead of you, The Anticlimactic Path probably leads somewhere really amazing.

You can see a launchpad and a rocket here.

>b
Sequel Path
You are on the the sequel path.  Backwards from here is The Land of Unlaunched Vessels.  Forward is The Land of Unlaunched Vessels II: The Launchening.

>b
The Land of Unlaunched Vessels
You are in the The Land of Unlaunched Vessels.  You stand near the edge of the bay, and there is a vessel moored here with thick and aged ropes tied to a bollard.  The Hopeful Path leads backward towards The Land of Unrealized Possibilities, a place you're not sure you want to be.  Forward, Sequel Path leads to The Land of Unlaunched Vessels II: The Launchening.

You can see an a swarthy hippie seaperson here.

>b
Seaside Path
You are on the the seaside path.  Backwards from here is The Land of Unrealized Possibilities.  Forward is The Land of Unlaunched Vessels.

>b
The Land of Unrealized Possibilities
You are in the Land of Unrealized Possibilities.  Just being here gives you a sense of all that could be accomplished if enough time, effort, and focus were pointed in a specific direction.  There is an sense of both excitement and disappointment here that is almost palpable.  The Hopeful Path leads backward towards The Land of Breakfast and Lunch, a place with a much clearer sense of purpose.

You can see a toy box (closed), a couch (on which is your brother), a TV, and a kiddie ride here.

>b
Hopeful Path
You are on the hopeful path.  Backwards from here is The Land of Breakfast and Lunch.  Forward is The Land of Unrealized Possibilities.

* * *

>eat breakfas
You can't see any such thing.

>eat breakfast
(Breakfast)
You sit down for a moment and eat breakfast.  It is delicious but you still don't quite feel satisfied.

* * *

>f
Anticlimactic Path
You are on the anticlimactic path.  Backwards is The Land of Unlaunched Vessels II: The Launchening.  Ahead of you, you can see the back of the liquor store.

>b
The Land of Unlaunched Vessels II: The Launchening
You are in The Land of Unlaunched Vessels II: The Launchening.  There is a launchpad here, on which sits a large, 1950's era rocket in galaxy white and candy-apple red. The Sequel Path leads backwards towards The Land of Unlaunched Vessels.  Ahead of you, The Anticlimactic Path probably leads somewhere really amazing.

You can see a launchpad and a rocket here.

>b
Sequel Path
You are on the sequel path.  Backwards from here is The Land of Unlaunched Vessels.  Forward is The Land of Unlaunched Vessels II: The Launchening.

>b
The Land of Unlaunched Vessels
You are in The Land of Unlaunched Vessels.  You stand near the edge of the bay, and there is a sailing ship moored here with thick and aged ropes tied to a bollard.  The Hopeful Path leads backward towards The Land of Unrealized Possibilities, a place you're not sure you want to be.  Forward, Sequel Path leads to The Land of Unlaunched Vessels II: The Launchening.

You can see a swarthy hippie seaperson here.

>b
Seaside Path
You are on the seaside path.  Backwards from here is The Land of Unrealized Possibilities.  Forward is The Land of Unlaunched Vessels.

>b
The Land of Unrealized Possibilities
You are in the Land of Unrealized Possibilities.  Just being here gives you a sense of all that could be accomplished if enough time, effort, and focus were pointed in a specific direction.  There is a sense of both excitement and disappointment here that is almost palpable.  The Hopeful Path leads backward towards The Land of Breakfast and Lunch, a place with a much clearer sense of purpose.

You can see a toy box (closed), a couch (on which is your brother), and a TV here.

>read wrinkled poem
"Wrm allre my lv," you remember it saying.

* * *

>b
The Land of Unlaunched Vessels
You are in The Land of Unlaunched Vessels.  You stand near the edge of the bay, and there is a sailing ship moored here with thick and aged ropes tied to a bollard.  The Hopeful Path leads backward towards The Land of Unrealized Possibilities, a place you're not sure you want to be.  Forward, Sequel Path leads to The Land of Unlaunched Vessels II: The Launchening.

You can see a swarthy hippie seaperson here.

>seaperson, take mast
"Although I am not technically the captain of The Chimera, I do not generally take orders from strangers."

>seaperson, take ball
"Although I am not technically the captain of The Chimera, I do not generally take orders from strangers."

>seaperson, take tennis ball
"Although I am not technically the captain of The Chimera, I do not generally take orders from strangers."

* * *

>f
The Path Around the Liquor Store
You're on the path around the liquor store.  You see the side of the liquor store on one side and a fence on the other side.

>f
The Land in Front of the Liquor Store
The Land in Front of the Liquor Store looks mostly abandoned, and you feel a slight sense of disappointment and dread here.  The liquor store is closed, looks like permanently, and there's just a weird kiddie ride here.  There are marks on the sidewalk where some other metal vending machines were, but it looks like they've been carted away.  Only the kiddie ride remains.  It's pretty depressing here, but if you continue to go forward, the Idyllic Path leads to The Land of Puppy Cardiovascular health, which is the H.

You can see a kiddie ride here.

>f
Idyllic Path
You are on the idyllic path.  Backwards from here is the liquor store, probably.  Forward is The Land of Puppy Cardiovascular Health.

>b
The front of the liquor store
The liquor store is closed, looks like permanantly, and there's just a weird humvee kiddie ride here.

You can see a kiddie ride here.

>ride ride
You climb up on the molded fiberglass seat of the humvee but it feels cold, joyless, and dead underneath you.  You distinctly feel the feeling of being so unloved that no one would put a quarter in the slot, not understanding how such a simple thing could make all the difference.  You slide slowly off.

>b
The path around the liquor store
You're on the path around the liquor store.  You see the side of the liquor store on one side and a fence on the other side.

>b
Behind the liquor store
You've got your standard collection of broken down boxes, a dumpster, and a stack of pallets.  Behind you, the anticlimactic path leads to The Land of Unlaunched Vessels II: The Launchening.

>b
The anticlimactic path.
You are on the anticlimactic path.  Backwards is The Land of Unlaunched Vessels II: The Launchening.  Ahead of you, you can see the back of the liquor store.

>b
The Land of Unlaunched Vessels II: The Launchening
You are in The Land of Unlaunched Vessels II: The Launchening.  There is a launchpad here, on which sits a large, 1950's era rocket in galaxy white and candy-apple red. Sequel Path leads backwards towards The Land of Unlaunched Vessels

You can see a launchpad and a Rocket here.

>b
Sequel Path
You are on the the sequel path.  Backwards from here is The Land of Unlaunched Vessels.  Forward is The Land of Unlaunched Vessels II: The Launchening.

>b
The Land of Unlaunched Vessels
You are in the The Land of Unlaunched Vessels.  You stand near the edge of the bay, and there is a sailing ship moored here with thick and aged ropes tied to a bollard.  The Hopeful Path leads backward towards The Land of Unrealized Possibilities, a place you're not sure you want to be.  Forward, Sequel Path leads to The Land of Unlaunched Vessels II: The Launchening.

You can see an a swarthy hippie seaperson here.

>b
Seaside Path
You are on the the seaside path.  Backwards from here is The Land of Unrealized Possibilities.  Forward is The Land of Unlaunched Vessels.

>b
The Land of Unrealized Possibilities
You are in the Land of Unrealized Possibilities.  Just being here gives you a sense of all that could be accomplished if enough time, effort, and focus were pointed in a specific direction.  There is an sense of both excitement and disappointment here that is almost palpable.  The Hopeful Path leads backward towards The Land of Breakfast and Lunch, a place with a much clearer sense of purpose.

You can see a toy box (closed), a couch (on which is your brother), and a TV here.

>look under couch
There's nothing under there except a small, grimy penny.

>get penny
Taken.

>f
Seaside Path
You are on the the seaside path.  Backwards from here is The Land of Unrealized Possibilities.  Forward is The Land of Unlaunched Vessels.

>f
The Land of Unlaunched Vessels
You are in the The Land of Unlaunched Vessels.  You stand near the edge of the bay, and there is a sailing ship moored here with thick and aged ropes tied to a bollard.  The Hopeful Path leads backward towards The Land of Unrealized Possibilities, a place you're not sure you want to be.  Forward, Sequel Path leads to The Land of Unlaunched Vessels II: The Launchening.

You can see an a swarthy hippie seaperson here.

>f
Sequel Path
You are on the the sequel path.  Backwards from here is The Land of Unlaunched Vessels.  Forward is The Land of Unlaunched Vessels II: The Launchening.

* * *

>f
The Land of Unlaunched Vessels II: The Launchening
You are in The Land of Unlaunched Vessels II: The Launchening.  There is a launchpad here, on which sits a large, 1950's era rocket in galaxy white and candy-apple red. Sequel Path leads backwards towards The Land of Unlaunched Vessels

You can see a launchpad and a Rocket here.

>f
The anticlimactic path.
You are on the anticlimactic path.  Backwards is The Land of Unlaunched Vessels II: The Launchening.  Ahead of you, you can see the back of the liquor store.

>f
Behind the liquor store
You've got your standard collection of broken down boxes, a dumpster, and a stack of pallets.  Behind you, the anticlimactic path leads to The Land of Unlaunched Vessels II: The Launchening.

>f
The path around the liquor store
You're on the path around the liquor store.  You see the side of the liquor store on one side and a fence on the other side.

>f
The front of the liquor store
The liquor store is closed, looks like permanantly, and there's just a weird humvee kiddie ride here.

You can see a kiddie ride here.

>put penny in slot
The penny slides down the chute, briefly contacts some mechanism inside, and clanks out the coin return tray.

>ride ride
You climb up on the molded fiberglass seat of the humvee but it feels cold, joyless, and dead underneath you.  You distinctly feel the feeling of being so unloved that no one would put a quarter in the slot, not understanding how such a simple thing could make all the difference.  You slide slowly off.

* * *

>b
The Land of Unrealized Possibilities
You are in the Land of Unrealized Possibilities.  Just being here gives you a sense of all that could be accomplished if enough time, effort, and focus were pointed in a specific direction.  There is an sense of both excitement and disappointment here that is almost palpable.  The Hopeful Path leads backward towards The Land of Breakfast and Lunch, a place with a much clearer sense of purpose.

You can see a toy box (closed), a couch (on which is your brother), and a TV here.

>b
Hopeful Path
You are on the hopeful path.  Backwards from here is The Land of Breakfast and Lunch.  Forward is The Land of Unrealized Possibilities.

* * *

>climb ladder
You pull yourself into the rocket.

The Inside of the Parked Rocket
You are within the smooth walls of the rocket.  It is very plain here, out the porthole window you can see the sky, and out the hatch you can see The Land of Unlaunched Vessels II: The Launchening.

You can see a the cockpit, a big metal unit containing a captain's chair and a control panel here.

>press launch
It's natural to expect blastoff immediately.  Instead, the hatch door whirrs slowly shut, coming to a solid clang.  You have just enough time to realize that you could buckle yourself into the captain's chair and you do.  Just in time, as you feel a tremendous slow and steady thrust of force wrap itself around you as the sky begins to move in the porthole window.  For just one moment you swear you can see The Land of Breakfast and Lunch streak by the window.  Finally, the sky begins to darken, and all sound becomes only a vibration.  The deep, dark void of space is with you.  You absentmindedly unbuckle the webbing securing you to the seat, and you feel free to move about the interior.

The Deep, Dark Void of Space
You are inside the rocket as it cruises very slowly through the deep, dark void of space.  Outside the porthole window is the deep, dark void of space covered over with a curtain of stars.

>look window
If you push your head out a little past the walls of the ship into the bubble of the porthole window, you can see quite a vista.   It's hard to make out any specific detail here, just a ceaseless curtain of stars that extends forever.  All of it looks very far away.

>look porthole
If you push your head out a little past the walls of the ship into the bubble of the porthole window, you can see quite a vista.   It's hard to make out any specific detail here, just a ceaseless curtain of stars that extends forever.  All of it looks very far away.

>press forward
Whoosh.  You thought maybe the engine engaged again, but something else already did.  It bent space softly around you, and, maybe the rocket moved a little.  Like with a soft whoosh.  It happened in less than a second.  Now, you think you're somewhere else.

Chrysocolla Cluster
You are inside the rocket as it cruises very slowly through the deep, dark void of space.  Outside the porthole window is the deep, dark void of space covered over with a curtain of stars.

You notice something unusual outside the porthole window.

>look window
Just outside the window is a simian businessperson, with a tidy leather jetpack.  Behind them is a curtain of stars.

>look out window
I only understood you as far as wanting to look outside.

>look porthole
Just outside the window is a simian businessperson, with a tidy leather jetpack.  Behind them is a curtain of stars.

* * *

>f
Idyllic Path
You are on the idyllic path.  Backwards from here is the liquor store, probably.  Forward is The Land of Puppy Cardiovascular Health.

>f
The Land of Puppy Cardiovascular Health
The meadows are wide and rolling here.  Mister Tuxedo leaps and cavorts excitedly, barking every now and again.

You can see a post and a power outlet here.

>b
Idyllic Path
You are on the idyllic path.  Backwards from here is the liquor store, probably.  Forward is The Land of Puppy Cardiovascular Health.

>b
The Land in Front of the Liquor Store
The Land in Front of the Liquor Store looks mostly abandoned, and you feel a slight sense of disappointment and dread here.  The liquor store is closed, looks like permanently, and there's just a weird kiddie ride here.  There are marks on the sidewalk where some other metal vending machines were, but it looks like they've been carted away.  Only the kiddie ride remains.  It's pretty depressing here, but if you continue to go forward, the Idyllic Path leads to The Land of Puppy Cardiovascular health, which is the H.

You can see a kiddie ride here.

>look kiddie ride
Off to the side a little ways is a mechanical kiddie ride.  It's a big (to a child) yellow humvee with cartoon human eyes where the headlights should be.  It's anchored to a diamond plate platform and looks to have stopped mid-tilt.

Mounted on a post next to it is a coin box showing the coin denomination necessary to make it run: 25, or one U.S. quarter dollar piece.

There were once two of these rides outside every grocery store in America.  Whether they died out because kids collectively realized they weren't fun, or just liability, you're surprised to see this one here.  It's plugged into the liquor store wall.

The kiddie ride is currently switched off.

* * *

>f
The Land of Puppy Cardiovascular Health
The meadows are wide and rolling here.  Mister Tuxedo leaps and cavorts excitedly, barking every now and again.

You can see a post and a power outlet here.

>look mister
Mister Tuxedo is a young, healthy dog in the very prime of his life.  He's black all over except the tips of his front paws, and the bottom of his chin and belly, giving him the appearance of permanent formalwear.  He is a very handsome dog, and his honoric (Mister) is never abbreviated as "Mr.".  You can call him "Mister" or "Tuxedo", but not "Mr." or "Mr. Tuxedo".  It's for a good reason, I promise.

Mister Tuxedo lives only to leap, cavort, and catch a thrown ball.

* * *

>f
The Land of Puppy Cardiovascular Health
The meadows are wide and rolling here.  Mister Tuxedo leaps and cavorts excitedly, barking every now and again.

You can see a post and a power outlet here.

>s
The Land in Front of the Liquor Store
The Land in Front of the Liquor Store looks mostly abandoned, and you feel a slight sense of disappointment and dread here.  The liquor store is closed, looks like permanently, and there's just a weird kiddie ride here.  There are marks on the sidewalk where some other metal vending machines were, but it looks like they've been carted away.  Only the kiddie ride remains.

You can see a kiddie ride here.

>look store
The liquor store looks closed, but pretty recently.  Liquor advertisements are hung in the windows.

>look ads
You read one of the advertisements, it says "Smoother than any angel.".

>look ads
You read one of the advertisements, it says "Real Good.  Real Smooth.".

* * *

>f
The Land in Front of the Liquor Store
The Land in Front of the Liquor Store looks mostly abandoned, and you feel a slight sense of disappointment and dread here.  The liquor store is closed, looks like permanently, and there's just a weird kiddie ride here.  There are marks on the sidewalk where some other metal vending machines were, but it looks like they've been carted away.  Only the kiddie ride remains.  It's pretty depressing here, but if you continue to go forward, the Idyllic Path leads to The Land of Puppy Cardiovascular health, which is the H.

You can see a kiddie ride here.

>ride kiddie ride
You climb up on the molded fiberglass seat of the humvee but it feels cold, joyless, and dead underneath you.  You distinctly feel the feeling of being so unloved that no one would put a quarter in the slot, not understanding how such a simple thing could make all the difference.  You slide slowly off.

>f
A white, hazy place that barely exists.
You find yourself in a white, hazy place that barely exists.  You were going forward from the liquor store, and now you find yourself here.  It feels confusing, and chilly, and fictional.

>f
You can't go that way.

>n
You can't go that way.

>b
The front of the liquor store
The liquor store is closed, looks like permanantly, and there's just a weird humvee kiddie ride here.

You can see a kiddie ride here.

>b
The path around the liquor store
You're on the path around the liquor store.  You see the side of the liquor store on one side and a fence on the other side.

>f
The front of the liquor store
The liquor store is closed, looks like permanantly, and there's just a weird humvee kiddie ride here.

You can see a kiddie ride here.

>f
A white, hazy place that barely exists.
You find yourself in a white, hazy place that barely exists.  You were going forward from the liquor store, and now you find yourself here.  It feels confusing, and chilly, and fictional.

* * *

>f
You can't go that way.

>b
The front of the liquor store
The liquor store is closed, looks like permanantly, and there's just a weird humvee kiddie ride here.

You can see a kiddie ride here.

>n
A white, hazy place that barely exists.
You find yourself in a white, hazy place that barely exists.  You were going forward from the liquor store, and now you find yourself here.  It feels confusing, and chilly, and fictional.

>f
You can't go that way.

* * *

>b
The front of the liquor store
The liquor store is closed, looks like permanantly, and there's just a weird humvee kiddie ride here.

You can see a kiddie ride here.

>f
A white, hazy place that barely exists.
You find yourself in a white, hazy place that barely exists.  You were going forward from the liquor store, and now you find yourself here.  It feels confusing, and chilly, and fictional.

* * *

>f
You can't go that way.

>f
You can't go that way.

* * *

>f
The Land in Front of the Liquor Store
The Land in Front of the Liquor Store looks mostly abandoned, and you feel a slight sense of disappointment and dread here.  The liquor store is closed, looks like permanently, and there's just a weird kiddie ride here.  There are marks on the sidewalk where some other metal vending machines were, but it looks like they've been carted away.  Only the kiddie ride remains.  It's pretty depressing here, but if you continue to go forward, the Idyllic Path leads to The Land of Puppy Cardiovascular health, which is the H.

You can see a kiddie ride here.

>x ad
You read one of the advertisements, it says "You can't get any smoother than that.".

>x ad
You read one of the advertisements, it says "The smoothness that works every time.".

>x ad
You read one of the advertisements, it says "You can't get any smoother than that.".

>x ad
You read one of the advertisements, it says "Girl, you smooth.".

>x ad
You read one of the advertisements, it says "Real Good.  Real Smooth.".

>x ad
You read one of the advertisements, it says "Girl, you smooth.".

>x ad
You read one of the advertisements, it says "The most expensive kind of smooth.".

>x ad
You read one of the advertisements, it says "It's Smoothtory time.".

>x ad
You read one of the advertisements, it says "Girl, you smooth.".

>x ad
You read one of the advertisements, it says "When you want the smoothest.".

>x ad
You read one of the advertisements, it says "When you want the smoothest.".

>x ad
You read one of the advertisements, it says "Smooth, smooth, smooth.".

>x ad
You read one of the advertisements, it says "Girl, you smooth.".

>x ad
You read one of the advertisements, it says "Sand your liquor down with 600 grit sandpaper and this is what you get: the smoothest.".

>x ad
You read one of the advertisements, it says "The most expensive kind of smooth.".

>x ad
You read one of the advertisements, it says "Smooth like the surface of a lake in a windless valley.".

>x ad
You read one of the advertisements, it says "The smoothness that works every time.".

>x ad
You read one of the advertisements, it says "The smoothness that works every time.".

>x ad
You read one of the advertisements, it says "Smooth like the surface of a lake in a windless valley.".

>x ad
You read one of the advertisements, it says "Sand your liquor down with 600 grit sandpaper and this is what you get: the smoothest.".

>x ad
You read one of the advertisements, it says "It's Smoothtory time.".

>x ad
You read one of the advertisements, it says "Sand your liquor down with 600 grit sandpaper and this is what you get: the smoothest.".

>x ad
You read one of the advertisements, it says "You can't get any smoother than that.".

>x ad
You read one of the advertisements, it says "When you want the smoothest.".

>throw
(the kiddie ride)
The kiddie ride is already here.

>throw block
You can't see any such thing.

>s
The Path Around the Liquor Store
You're on the path around the liquor store.  You see the side of the liquor store on one side and a fence on the other side.

>s
The Land Behind the Liquor Store
You are in The Land Behind the Liquor Store.  It's underwhelming.  You've got your standard collection of broken down boxes, a dumpster, and a stack of pallets.  Behind you, the anticlimactic path leads to The Land of Unlaunched Vessels II: The Launchening.  Ahead of you, The Path Around the Liquor Store leads to The Land in Front of the Liquor Store.

* * *

>f
Anticlimactic Path
You are on the anticlimactic path.  Backwards is The Land of Unlaunched Vessels II: The Launchening.  Ahead of you, you can see the back of the liquor store.

>open hatch
You open the hatch.

* * *

>climb ladder
You pull yourself into the rocket.

The Inside of the Parked Rocket
You are within the smooth walls of the rocket.  It is very plain here, out the porthole window you can see The Land of Unlaunched Vessels II: The Launchening.

You can see a the cockpit, a big metal unit containing a captain's chair and a control panel here.

>press red button
You're too hungry to go to space.

* * *

>f
The Land of Unlaunched Vessels II: The Launchening
You are in The Land of Unlaunched Vessels II: The Launchening.  There is a launchpad here, on which sits a large, 1950's era rocket in galaxy white and candy-apple red. The Sequel Path leads backwards towards The Land of Unlaunched Vessels.  Ahead of you, The Anticlimactic Path probably leads somewhere really amazing.

You can see a launchpad and a rocket here.

>go swimming
You don't want to get wet, and you don't think you'd be able to get on the vessel that way, or really be able to do much of anything.

* * *

>f
The Land of Unlaunched Vessels II: The Launchening
You are in The Land of Unlaunched Vessels II: The Launchening.  There is a launchpad here, on which sits a large, 1950's era rocket in galaxy white and candy-apple red. The Sequel Path leads backwards towards The Land of Unlaunched Vessels.  Ahead of you, The Anticlimactic Path probably leads somewhere really amazing.

You can see a launchpad and a rocket here.

>look launchpad
The launchpad appears to be just a featureless steel box set into the ground.  Only a few inches of it protrude up to support the rocket.  It has a mirrory shine, as if the rocket had never been launched.

>look porthole
The porthole is the single window of the rocket, and it bubbles out from the body of the rocket so when you're inside, you can see a wider vista.  It has a pleasant curve to it.

>look through porthole
You find nothing of interest.

* * *

>f
The Land of Unlaunched Vessels II: The Launchening
You are in The Land of Unlaunched Vessels II: The Launchening.  There is a launchpad here, on which sits a large, 1950's era rocket in galaxy white and candy-apple red. The Sequel Path leads backwards towards The Land of Unlaunched Vessels.  Ahead of you, The Anticlimactic Path probably leads somewhere really amazing.

You can see a launchpad and a rocket here.

>look porthole
The porthole is the single window of the rocket, and it bubbles out from the body of the rocket so when you're inside, you can see a wider vista.  It has a pleasant curve to it.

>look through porthole
From outside the rocket, the rounded curve of the porthole looks almost metallic.  You assume it's transparent from the inside.

>look out porthole
From outside the rocket, the rounded curve of the porthole looks almost metallic.  You assume it's transparent from the inside.

>look through hatch
The hatch is closed, and you're not able to see through it.  It looks like you could open it, however.

>look in hatch
The hatch is closed, and you're not able to see through it.  It looks like you could open it, however.

>look out hatch
The hatch is closed, and you're not able to see through it.  It looks like you could open it, however.

>open hatch
You open the hatch.

>look through hatch
You can tell there's not much inside the rocket but smooth walls and some sort of cockpit.

>enter hatch
That's not something you can enter.

* * *

>f
The Land of Unlaunched Vessels II: The Launchening
You are in The Land of Unlaunched Vessels II: The Launchening.  There is a launchpad here, on which sits a large, 1950's era rocket in galaxy white and candy-apple red. The Sequel Path leads backwards towards The Land of Unlaunched Vessels.  Ahead of you, The Anticlimactic Path probably leads somewhere really amazing.

You can see a launchpad and a rocket here.

>look sea
You stand at the edge of the bay.  It could be any kind of inlet, possibly a fjord, but it's too calm to be the sea itself, and you can't see land on the other side.  Let's call it a bay.  A concrete retaining wall allows you to stand right at the edge of it.

>look wall
A cement retaining wall keeping the land seperate from the bay.

>swim
You don't want to get wet, and you don't think you'd be able to get on the vessel that way, or really be able to do much of anything.

>swim in bay
I only understood you as far as wanting to swim.

* * *

>f
The Land of Unlaunched Vessels II: The Launchening
You are in The Land of Unlaunched Vessels II: The Launchening.  There is a launchpad here, on which sits a large, 1950's era rocket in galaxy white and candy-apple red. The Sequel Path leads backwards towards The Land of Unlaunched Vessels.  Ahead of you, The Anticlimactic Path probably leads somewhere really amazing.

You can see a launchpad and a rocket here.

>up
The hatch is closed.

>open hatch
You open the hatch.

>up
You pull yourself into the rocket.

The Inside of the Parked Rocket
You are within the smooth walls of the rocket.  It is very plain here, out the porthole window you can see the sky, and out the hatch you can see The Land of Unlaunched Vessels II: The Launchening.

You can see a cockpit, a big metal unit containing a captain's chair and a control panel here.

* * *

>f
Sequel Path
You are on the sequel path.  Backwards from here is The Land of Unlaunched Vessels.  Forward is The Land of Unlaunched Vessels II: The Launchening.

>look seaperson
She has thick blonde dreds, and all her eyes and limbs.  You can't tell if she's the piratey kind of seaperson or not.

>kiss seaperson
She pulls her head way back and eyes you with suspicion.  When you think about it, you realize you just kind of embarrassed yourself.

>b
Seaside Path
You are on the the seaside path.  Backwards from here is The Land of Unlaunched Vessels.  Forward is The Land of Unlaunched Vessels.

>b
The Land of Unrealized Possiblities
You are in the Land of Unrealized Possibilities.  Just being here gives you a sense of all that could be accomplished if enough time, effort, and focus were pointed in a specific direction.  There is an sense of both excitement and disappointment here that is almost palpable.  The Hopeful Path leads backward towards The Land of Breakfast and Lunch, a place with a much clearer sense of purpose.

You can see a toy box (closed), a couch (on which is your brother), and a TV here.

>look tv
An early 35" flatscreen.  Bulky, black, and plastic.  It lived in your den for way too long, just because no one wanted to lift it.  It's odd to see it here, in The Land of Unrealized Possibilities.  It is playing Blue Planet IV on channel 14.

>turn off tv
"C'mon, Farts McJohnson," your brother says, wearily, "I'm watching this."

>switch off tv
"C'mon, Farts McJohnson," your brother says, wearily, "I'm watching this."

>x tv
An early 35" flatscreen.  Bulky, black, and plastic.  It lived in your den for way too long, just because no one wanted to lift it.  It's odd to see it here, in The Land of Unrealized Possibilities.  It is playing Apartheid Bunnies on channel 23.

* * *

>look seaperson
She has thick blonde dreds, and all her eyes and limbs.  You can't tell if she's the piratey kind of seaperson or not.

>look hippier
You can't see any such thing.

>look hippie
She has thick blonde dreds, and all her eyes and limbs.  You can't tell if she's the piratey kind of seaperson or not.

>look knot
They're not knots you'd recognize.  They seem needlessly complicated.

>untie knot
As you begin to work on the knots, the hippie seaperson looks quizzically at you for a moment, to see if you know the art of deciphering such a thing.  After watching you pull at them ineffectually for a few minutes, she loses interest.  You can barely move the heavy rope.

* * *

>f
Sequel Path
You are on the sequel path.  Backwards from here is The Land of Unlaunched Vessels.  Forward is The Land of Unlaunched Vessels II: The Launchening.

>s
Seaside Path
You are on the the seaside path.  Backwards from here is The Land of Unrealized Possibilities.  Forward is The Land of Launching and Mooring.

>s
The Land of Unrealized Possiblities
You are in the Land of Unrealized Possibilities.  Just being here gives you a sense of all that could be accomplished if enough time, effort, and focus were pointed in a specific direction.  There is an sense of both excitement and disappointment here that is almost palpable.  The Hopeful Path leads backward towards The Land of Breakfast and Lunch, a place with a much clearer sense of purpose.

You can see a toy box (closed) here.

>open box
You open the toy box, revealing a wooden block, a small heart shaped locket, and a small hobby horse.

>look horse
It is a small, wooden hobby horse.  It's very sturdily built, but made to entertain a three-year old.  It has yarn for a mane.

>ride horse
The hobby horse takes up most of the box, and doesn't allow a lot of room to ride it.
You were pretty sure it was going to be awkward to do this, and it sure is.  Your legs are splayed way out and the hobby horse creaks dangerously under your weight.  It holds solid though, and you creak your way back and forward a few times.  You can say you did it.

>get horse
Taken.

>ride horse
You're holding the hobby horse in both of your hands.  Anyone would be impressed if you found a way to ride it right now.

>drop horse
Dropped.

>ride horse
You were pretty sure it was going to be awkward to do this, and it sure is.  Your legs are splayed way out and the hobby horse creaks dangerously under your weight.  It holds solid though, and you creak your way back and forward a few times.  You can say you did it.

>look self
You are a fictional character who looks very much like the non-fictional you looks.  Almost exactly, in fact, except the non-fictional you is slightly more attractive, and the fictional you is a slightly better speller.

* * *

>f
Sequel Path
You are on the sequel path.  Backwards from here is The Land of Unlaunched Vessels.  Forward is The Land of Unlaunched Vessels II: The Launchening.

>swim
You don't want to get wet, and you don't think you'd be able to get on the vessel that way, or really be able to do much of anything.

>swim bay
You don't want to get wet, and you don't think you'd be able to get on the vessel that way, or really be able to do much of anything.

>swim in the bay
You don't want to get wet, and you don't think you'd be able to get on the vessel that way, or really be able to do much of anything.

* * *

>f
The Land of Unlaunched Vessels
You are in The Land of Unlaunched Vessels.  You stand near the edge of the bay, and there is a sailing ship moored here with thick and aged ropes tied to a bollard.  The Hopeful Path leads backward towards The Land of Unrealized Possibilities, a place you're not sure you want to be.  Forward, Sequel Path leads to The Land of Unlaunched Vessels II: The Launchening.

You can see a swarthy hippie seaperson here.

>get quarter
You can't see any such thing.

>put coin in slot
Which do you mean, the coin box, the coin slot, the coin return tray, or the coin release button?

>put quarter in slot
You can't see any such thing.

>look ride
Off to the side a little ways is a mechanical kiddie ride.  It's a big (to a child) yellow humvee with cartoon human eyes where the headlights should be.  It's anchored to a diamond plate platform and looks to have stopped mid-tilt.

Mounted on a post next to it is a coin box showing the coin denomination necessary to make it run: 25, or one U.S. quarter dollar piece.

There were once two of these rides outside every grocery store in America.  Whether they died out because kids collectively realized they weren't fun, or just liability, you're surprised to see this one here.

The kiddie ride is currently switched off.

>i
You examine what you'd normally use to carry things, all the way from fingertip to elbow.  As you suspected, nothing is contained there.  You briefly check for pockets or some kind of fanny pack.  There isn't anything like that.  You are forced to conclude that you have no possessions.

>ride ride
You climb up on the molded fiberglass seat of the humvee but it feels cold, joyless, and dead underneath you.  You distinctly feel the feeling of being so unloved that no one would put a quarter in the slot, not understanding how such a simple thing could make all the difference.  You slide slowly off.

* * *

>f
The Land of Unlaunched Vessels
You are in The Land of Unlaunched Vessels.  You stand near the edge of the bay, and there is a sailing ship moored here with thick and aged ropes tied to a bollard.  The Hopeful Path leads backward towards The Land of Unrealized Possibilities, a place you're not sure you want to be.  Forward, Sequel Path leads to The Land of Unlaunched Vessels II: The Launchening.

You can see a swarthy hippie seaperson here.

>hippie, walk north
"Although I am not technically the captain of The Chimera, I do not generally take orders from strangers."

* * *

>f
The Land of Unlaunched Vessels
You are in The Land of Unlaunched Vessels.  You stand near the edge of the bay, and there is a sailing ship moored here with thick and aged ropes tied to a bollard.  The Hopeful Path leads backward towards The Land of Unrealized Possibilities, a place you're not sure you want to be.  Forward, Sequel Path leads to The Land of Unlaunched Vessels II: The Launchening.

You can see a swarthy hippie seaperson here.

>look bay
You stand at the edge of the bay.  It could be any kind of inlet, possibly a fjord, but it's too calm to be the sea itself, and you can't see land on the other side.  Let's call it a bay.

* * *

>f
The Land of Unlaunched Vessels
You are in The Land of Unlaunched Vessels.  You stand near the edge of the bay, and there is a sailing ship moored here with thick and aged ropes tied to a bollard.  The Hopeful Path leads backward towards The Land of Unrealized Possibilities, a place you're not sure you want to be.  Forward, Sequel Path leads to The Land of Unlaunched Vessels II: The Launchening.

You can see a swarthy hippie seaperson here.

>look mast
The fluyt has three main masts.  Near the top of the back mast, there is a tennis ball attached.

>look ball
It's a tennis ball.  It is somehow attached way up high on the rear mast.  You're not sure why or how.

>look tennis ball
It's a tennis ball.  It is somehow attached way up high on the rear mast.  You're not sure why or how.

>get tennis ball
That seems to be a part of the masts.

>climb masts
There's no way you can even get on the deck of the ship, much less the masts.

>ask hippie about masts
"There are three main masts on The Chimera.  See?"

>ask hippie about ball
Oh, you want the tennis ball?  Sure.  She gets it for you.

>i
You are carrying:
  a tennis ball

>look mast
The fluyt has three main masts.

>look ball
It's a tennis ball.

>climb mast
There's no way you can even get on the deck of the ship, much less the masts.

>whistle
You try putting both fingers in your mouth, and letting out a sharp whistle, but you end up just spitting all over your fingers.

* * *

>f
The Land of Unlaunched Vessels
You are in The Land of Unlaunched Vessels.  You stand near the edge of the bay, and there is a sailing ship moored here with thick and aged ropes tied to a bollard.  The Hopeful Path leads backward towards The Land of Unrealized Possibilities, a place you're not sure you want to be.  Forward, Sequel Path leads to The Land of Unlaunched Vessels II: The Launchening.

You can see a swarthy hippie seaperson here.

>look ropes
The ropes are weathered but sturdy, with crusty barnacles aplenty.  They are tied with odd-looking knots to a giant metal bollard bolted to a cement retaining wall.

>look bollard
It's an incredibly sturdy metal tie-down bolted to a cement retaining wall.

>look wall
A cement retaining wall keeping the land seperate from the bay.

>look vessel
It's perhaps a trireme, and it's clearly under construction.

>swim
That's not a verb I recognize.

* * *

>f
The Land of Unlaunched Vessels
You are in The Land of Unlaunched Vessels.  You stand near the edge of the bay, and there is a sailing ship moored here with thick and aged ropes tied to a bollard.  The Hopeful Path leads backward towards The Land of Unrealized Possibilities, a place you're not sure you want to be.  Forward, Sequel Path leads to The Land of Unlaunched Vessels II: The Launchening.

You can see a swarthy hippie seaperson here.

>look through path
You can't see any such thing.

>look hatcg
You can't see any such thing.

>f
Sequel Path
You are on the the sequel path.  Backwards from here is The Land of Unlaunched Vessels.  Forward is The Land of Unlaunched Vessels II: The Launchening.

>look hatch
You can't see any such thing.

* * *

>f
The Land of Unlaunched Vessels
You are in The Land of Unlaunched Vessels.  You stand near the edge of the bay, and there is a sailing ship moored here with thick and aged ropes tied to a bollard.  The Hopeful Path leads backward towards The Land of Unrealized Possibilities, a place you're not sure you want to be.  Forward, Sequel Path leads to The Land of Unlaunched Vessels II: The Launchening.

You can see a swarthy hippie seaperson here.

>look vessel
It's perhaps a trireme, and it's clearly under construction.

* * *

>f
The Land of Unlaunched Vessels
You are in The Land of Unlaunched Vessels.  You stand near the edge of the bay, and there is a sailing ship moored here with thick and aged ropes tied to a bollard.  The Hopeful Path leads backward towards The Land of Unrealized Possibilities, a place you're not sure you want to be.  Forward, Sequel Path leads to The Land of Unlaunched Vessels II: The Launchening.

You can see a swarthy hippie seaperson here.

>smell bollard
Everything here smells like the sea.

* * *

>f
The Land of Unlaunched Vessels
You are in The Land of Unlaunched Vessels.  You stand near the edge of the bay, and there is a sailing ship moored here with thick and aged ropes tied to a bollard.  The Hopeful Path leads backward towards The Land of Unrealized Possibilities, a place you're not sure you want to be.  Forward, Sequel Path leads to The Land of Unlaunched Vessels II: The Launchening.

You can see a swarthy hippie seaperson here.

>smell ropes
Everything here smells like the sea.

>smell knot
Everything here smells like the sea.

* * *

>f
The Land of Unlaunched Vessels
You are in The Land of Unlaunched Vessels.  You stand near the edge of the bay, and there is a sailing ship moored here with thick and aged ropes tied to a bollard.  The Hopeful Path leads backward towards The Land of Unrealized Possibilities, a place you're not sure you want to be.  Forward, Sequel Path leads to The Land of Unlaunched Vessels II: The Launchening.

You can see a swarthy hippie seaperson here.

>untie knot
You can't see any such thing.

>untie knots
nah

* * *

>f
The Land of Unrealized Possibilities
You are in the Land of Unrealized Possibilities.  Just being here gives you a sense of all that could be accomplished if enough time, effort, and focus were pointed in a specific direction.  There is a sense of both excitement and disappointment here that is almost palpable.  The Hopeful Path leads backward towards The Land of Breakfast and Lunch, a place with a much clearer sense of purpose.  The Seaside Path leads forward, towards The Land of Unlaunched Vessels.

You can see a toy box (closed), a couch (on which is your brother), and a TV here.

>get remote
Your brother snatches the remote away from you and gives you a quick, dirty look that reminds you he's ready to back it up with the kind of painful violence that will not leave a mark.

>change channel
Your brother is holding the remote control.
True change comes from within.

* * *

>f
The Land of Unrealized Possibilities
You are in the Land of Unrealized Possibilities.  Just being here gives you a sense of all that could be accomplished if enough time, effort, and focus were pointed in a specific direction.  There is a sense of both excitement and disappointment here that is almost palpable.  The Hopeful Path leads backward towards The Land of Breakfast and Lunch, a place with a much clearer sense of purpose.  The Seaside Path leads forward, towards The Land of Unlaunched Vessels.

You can see a toy box (closed), a couch (on which is your brother), and a TV here.

>hit bro
You can't see any such thing.

>hit brother
Your brother would kick your ass.

>hit my brother
Your brother would kick your ass.

* * *

>f
The Land of Unrealized Possibilities
You are in the Land of Unrealized Possibilities.  Just being here gives you a sense of all that could be accomplished if enough time, effort, and focus were pointed in a specific direction.  There is a sense of both excitement and disappointment here that is almost palpable.  The Hopeful Path leads backward towards The Land of Breakfast and Lunch, a place with a much clearer sense of purpose.  The Seaside Path leads forward, towards The Land of Unlaunched Vessels.

You can see a toy box (closed), a couch (on which is your brother), and a TV here.

>hit brother
Your brother would kick your ass.

* * *

>hit my brother
Your brother would kick your ass.

>hit your brother
Your brother would kick your ass.

>annoy brother
I only understood you as far as wanting to annoy.

>annoy your brother
I only understood you as far as wanting to annoy.

* * *

>f
The Land of Unrealized Possibilities
You are in the Land of Unrealized Possibilities.  Just being here gives you a sense of all that could be accomplished if enough time, effort, and focus were pointed in a specific direction.  There is a sense of both excitement and disappointment here that is almost palpable.  The Hopeful Path leads backward towards The Land of Breakfast and Lunch, a place with a much clearer sense of purpose.  The Seaside Path leads forward, towards The Land of Unlaunched Vessels.

You can see a toy box (closed), a couch (on which is your brother), and a TV here.

>kick brother
Your brother nearly-psychically determines your intention. In a flash, he socks you in the quadricep with precision and speed.  He hits what you realize is an existing bruise from last time and you have to take deep breaths to keep from doubling over in pain.   "What's your problem, you aggro dipwad?" he says, distractedly, eyes still on the TV.

>hit brother
Your brother nearly-psychically determines your intention. In a flash, he socks you in the quadricep with precision and speed.  He hits what you realize is an existing bruise from last time and you have to take deep breaths to keep from doubling over in pain.   "What's your problem, you aggro dipwad?" he says, distractedly, eyes still on the TV.

>smell brother
Weirdly, he smells fine.

>talk brother
That's not a verb I recognize.

>talk to brother
That's not a verb I recognize.

>ask brother about locket
There is no reply.

>ride brother
You can't ride stuff like that, silly.

* * *

>kick brother
Your brother nearly-psychically determines your intention. In a flash, he socks you in the quadricep with precision and speed.  He hits what you realize is an existing bruise from last time and you have to take deep breaths to keep from doubling over in pain.   "What's your problem, you aggro dipwad?" he says, distractedly, eyes still on the TV.

>kick brother
Your brother has been on the planet a little longer than you, and he isn't tricked by your simple attacks.  He uses a simple karate chop to the solar plexus and you have to fight the urge to barf for a moment.

* * *

>kick brother
Your brother nearly-psychically determines your intention. In a flash, he socks you in the quadricep with precision and speed.  He hits what you realize is an existing bruise from last time and you have to take deep breaths to keep from doubling over in pain.   "What's your problem, you aggro dipwad?" he says, distractedly, eyes still on the TV.

>kick my brother
I only understood you as far as wanting to kick.

>attack brother
Your brother nearly-psychically determines your intention. In a flash, he socks you in the quadricep with precision and speed.  He hits what you realize is an existing bruise from last time and you have to take deep breaths to keep from doubling over in pain.   "What's your problem, you aggro dipwad?" he says, distractedly, eyes still on the TV.

* * *

>f
The Land of Unrealized Possibilities
You are in the Land of Unrealized Possibilities.  Just being here gives you a sense of all that could be accomplished if enough time, effort, and focus were pointed in a specific direction.  There is a sense of both excitement and disappointment here that is almost palpable.  The Hopeful Path leads backward towards The Land of Breakfast and Lunch, a place with a much clearer sense of purpose.  The Seaside Path leads forward, towards The Land of Unlaunched Vessels.

You can see a toy box (closed), a couch (on which is your brother), and a TV here.

>look brother
Your brother is a lean masterpiece of laziness and force.  He is devoted to his wasting of time right now and has himself wedged into the couch like a part of it. He is watching TV..

>ask brother about locket
You can only do that to something animate.

* * *

>look brother
Your brother is a lean masterpiece of laziness and force.  He is devoted to his wasting of time right now and has himself wedged into the couch like a part of it. He is watching TV..

>hug brother
A swift wave of nausea dissuades you.

>kiss brother
A swift wave of nausea dissuades you.

>ask brother
What do you want to ask your brother for?

>ask brother hi
I didn't understand that sentence.

>ask brother about locket
There is no reply.

* * *

>f
The Land of Unrealized Possibilities
You are in the Land of Unrealized Possibilities.  Just being here gives you a sense of all that could be accomplished if enough time, effort, and focus were pointed in a specific direction.  There is a sense of both excitement and disappointment here that is almost palpable.  The Hopeful Path leads backward towards The Land of Breakfast and Lunch, a place with a much clearer sense of purpose.  The Seaside Path leads forward, towards The Land of Unlaunched Vessels.

You can see a toy box (closed), a couch (on which is your brother), and a TV here.

>look couch
This is the blue corduroy couch of your youth.  You have rolled over on it many times and sat up to read it's wrinkled poem on your arm.  Why would anyone get a corduroy couch?

On the couch is your brother.

>look under couch
You find nothing of interest.

>look penny
You can't see any such thing.

>i
You examine what you'd normally use to carry things, all the way from fingertip to elbow.  As you suspected, nothing is contained there.  You briefly check for pockets or some kind of fanny pack.  There isn't anything like that.  You are forced to conclude that you have no possessions.

>w
You don't see anywhere to go except backwards and forwards.

>e
Around these parts, folks mostly go backwards or forwards.

>sw
You can't go that way.

* * *

>f
The Land of Unrealized Possibilities
You are in the Land of Unrealized Possibilities.  Just being here gives you a sense of all that could be accomplished if enough time, effort, and focus were pointed in a specific direction.  There is a sense of both excitement and disappointment here that is almost palpable.  The Hopeful Path leads backward towards The Land of Breakfast and Lunch, a place with a much clearer sense of purpose.  The Seaside Path leads forward, towards The Land of Unlaunched Vessels.

You can see a toy box (closed), a couch (on which is your brother), and a TV here.

>look locket
You can't see any such thing.

>open box
You open the toy box, revealing a wooden block, a small heart shaped locket, and a small hobby horse.

>open locket
You open the small heart shaped locket, revealing a faded picture of a child who looks a lot like you.

>get picture
Taken.

>put picture in locket
You gently slide the locket back in.

(first taking the faded picture of a child who looks a lot like you)
You put the faded picture of a child who looks a lot like you into the small heart shaped locket.

* * *

>f
The Land of Unrealized Possibilities
You are in the Land of Unrealized Possibilities.  Just being here gives you a sense of all that could be accomplished if enough time, effort, and focus were pointed in a specific direction.  There is a sense of both excitement and disappointment here that is almost palpable.  The Hopeful Path leads backward towards The Land of Breakfast and Lunch, a place with a much clearer sense of purpose.  The Seaside Path leads forward, towards The Land of Unlaunched Vessels.

You can see a toy box (closed), a couch (on which is your brother), and a TV here.

>look penny
You can't see any such thing.

>look couch
This is the blue corduroy couch of your youth.  You have rolled over on it many times and sat up to read it's wrinkled poem on your arm.  Why would anyone get a corduroy couch?

On the couch is your brother.

>look under couch
There's nothing under there except a small, grimy penny.

>ook penny
That's not a verb I recognize.

>x penny
It's a single penny, so grimy you can't read the date.  It looks older than 1982, which means it's made of solid copper, but coated in rust and grime.

>take penny
Taken.

>b
Hopeful Path
You are on the hopeful path.  Backwards from here is The Land of Breakfast and Lunch.  Forward is The Land of Unrealized Possibilities.

* * *

>eat lunch
(Lunch)
Lunch was wonderful.  Your stomach feels like a puzzle, where the final piece has finally been snapped into place.  You now feel as if you could take on the world.

>look dishes
Which do you mean, the breakfast dishes or the lunch dishes?

>look lunch dishes
You've politely stacked the lunch dishes, so the table doesn't look too messy.

>eat lunch
That's plainly inedible.

* * *

>f
The Land of Unrealized Possibilities
You are in the Land of Unrealized Possibilities.  Just being here gives you a sense of all that could be accomplished if enough time, effort, and focus were pointed in a specific direction.  There is a sense of both excitement and disappointment here that is almost palpable.  The Hopeful Path leads backward towards The Land of Breakfast and Lunch, a place with a much clearer sense of purpose.  The Seaside Path leads forward, towards The Land of Unlaunched Vessels.

You can see a toy box (closed), a couch (on which is your brother), and a TV here.

>look tv
An early 35" flatscreen.  Bulky, black, and plastic.  It lived in your den for way too long, just because no one wanted to lift it.  It's odd to see it here, in The Land of Unrealized Possibilities.  It is playing "Botswana (1992)" on channel 15.

>look tv
An early 35" flatscreen.  Bulky, black, and plastic.  It lived in your den for way too long, just because no one wanted to lift it.  It's odd to see it here, in The Land of Unrealized Possibilities.  It is playing "Samual McSamualson Rides Again" on channel 24.

>look tv
An early 35" flatscreen.  Bulky, black, and plastic.  It lived in your den for way too long, just because no one wanted to lift it.  It's odd to see it here, in The Land of Unrealized Possibilities.  It is playing "Dangerous Food of the Ganges" on channel 26.

>look tv
An early 35" flatscreen.  Bulky, black, and plastic.  It lived in your den for way too long, just because no one wanted to lift it.  It's odd to see it here, in The Land of Unrealized Possibilities.  It is playing "The Great Snafu (1956)" on channel 18.

>look tv
An early 35" flatscreen.  Bulky, black, and plastic.  It lived in your den for way too long, just because no one wanted to lift it.  It's odd to see it here, in The Land of Unrealized Possibilities.  It is playing "Blue Planet IV" on channel 14.

>look tv
An early 35" flatscreen.  Bulky, black, and plastic.  It lived in your den for way too long, just because no one wanted to lift it.  It's odd to see it here, in The Land of Unrealized Possibilities.  It is playing "Enraged Juggalos" on channel 13.

>look tv
An early 35" flatscreen.  Bulky, black, and plastic.  It lived in your den for way too long, just because no one wanted to lift it.  It's odd to see it here, in The Land of Unrealized Possibilities.  It is playing "Borderline Personality Island" on channel 19.

>look tv
An early 35" flatscreen.  Bulky, black, and plastic.  It lived in your den for way too long, just because no one wanted to lift it.  It's odd to see it here, in The Land of Unrealized Possibilities.  It is playing "Gorgon: The Magnificent" on channel 16.

>look tv
An early 35" flatscreen.  Bulky, black, and plastic.  It lived in your den for way too long, just because no one wanted to lift it.  It's odd to see it here, in The Land of Unrealized Possibilities.  It is playing "Samual McSamualson Rides Again" on channel 24.

>look tv
An early 35" flatscreen.  Bulky, black, and plastic.  It lived in your den for way too long, just because no one wanted to lift it.  It's odd to see it here, in The Land of Unrealized Possibilities.  It is playing "Botswana (1992)" on channel 15.

>look tv
An early 35" flatscreen.  Bulky, black, and plastic.  It lived in your den for way too long, just because no one wanted to lift it.  It's odd to see it here, in The Land of Unrealized Possibilities.  It is playing "Buck Rogers" on channel 12.

>look tv
An early 35" flatscreen.  Bulky, black, and plastic.  It lived in your den for way too long, just because no one wanted to lift it.  It's odd to see it here, in The Land of Unrealized Possibilities.  It is playing "Samual McSamualson Rides Again" on channel 24.

>look tv
An early 35" flatscreen.  Bulky, black, and plastic.  It lived in your den for way too long, just because no one wanted to lift it.  It's odd to see it here, in The Land of Unrealized Possibilities.  It is playing "Samual McSamualson Rides Again" on channel 24.

>look tv
An early 35" flatscreen.  Bulky, black, and plastic.  It lived in your den for way too long, just because no one wanted to lift it.  It's odd to see it here, in The Land of Unrealized Possibilities.  It is playing "Gorgon: The Magnificent" on channel 16.

>look tv
An early 35" flatscreen.  Bulky, black, and plastic.  It lived in your den for way too long, just because no one wanted to lift it.  It's odd to see it here, in The Land of Unrealized Possibilities.  It is playing "Speed Burners (1975)" on channel 29.

>look tv
An early 35" flatscreen.  Bulky, black, and plastic.  It lived in your den for way too long, just because no one wanted to lift it.  It's odd to see it here, in The Land of Unrealized Possibilities.  It is playing "The Great Snafu (1956)" on channel 18.

>look tv
An early 35" flatscreen.  Bulky, black, and plastic.  It lived in your den for way too long, just because no one wanted to lift it.  It's odd to see it here, in The Land of Unrealized Possibilities.  It is playing "Rad Fights VII (1984)" on channel 22.

>look tv
An early 35" flatscreen.  Bulky, black, and plastic.  It lived in your den for way too long, just because no one wanted to lift it.  It's odd to see it here, in The Land of Unrealized Possibilities.  It is playing "Dangerous Food of the Ganges" on channel 26.

>look tv
An early 35" flatscreen.  Bulky, black, and plastic.  It lived in your den for way too long, just because no one wanted to lift it.  It's odd to see it here, in The Land of Unrealized Possibilities.  It is playing "Samual McSamualson Rides Again" on channel 24.

>look tv
An early 35" flatscreen.  Bulky, black, and plastic.  It lived in your den for way too long, just because no one wanted to lift it.  It's odd to see it here, in The Land of Unrealized Possibilities.  It is playing "Beauty and the Embolism" on channel 25.

>look tv
An early 35" flatscreen.  Bulky, black, and plastic.  It lived in your den for way too long, just because no one wanted to lift it.  It's odd to see it here, in The Land of Unrealized Possibilities.  It is playing "Gorgon: The Magnificent" on channel 16.

>look tv
An early 35" flatscreen.  Bulky, black, and plastic.  It lived in your den for way too long, just because no one wanted to lift it.  It's odd to see it here, in The Land of Unrealized Possibilities.  It is playing "Thundercats" on channel 11.

>look tv
An early 35" flatscreen.  Bulky, black, and plastic.  It lived in your den for way too long, just because no one wanted to lift it.  It's odd to see it here, in The Land of Unrealized Possibilities.  It is playing "Dangerous Food of the Ganges" on channel 26.

>look tv
An early 35" flatscreen.  Bulky, black, and plastic.  It lived in your den for way too long, just because no one wanted to lift it.  It's odd to see it here, in The Land of Unrealized Possibilities.  It is playing "Blue Planet IV" on channel 14.

>look tv
An early 35" flatscreen.  Bulky, black, and plastic.  It lived in your den for way too long, just because no one wanted to lift it.  It's odd to see it here, in The Land of Unrealized Possibilities.  It is playing "Speed Burners (1975)" on channel 29.

>look tv
An early 35" flatscreen.  Bulky, black, and plastic.  It lived in your den for way too long, just because no one wanted to lift it.  It's odd to see it here, in The Land of Unrealized Possibilities.  It is playing "Botswana (1992)" on channel 15.

>look tv
An early 35" flatscreen.  Bulky, black, and plastic.  It lived in your den for way too long, just because no one wanted to lift it.  It's odd to see it here, in The Land of Unrealized Possibilities.  It is playing "How I Got in a Non-Hierarchical Triad with your Mother" on channel 21.

* * *

>open box
You open the toy box, revealing a wooden block, a skinny naked plastic doll, a closed jack-in-the-box, a lite-brite, a coloring book, a small heart shaped locket, and a small hobby horse.

>get all
wooden block: Taken.
skinny naked plastic doll: Taken.
closed jack-in-the-box: Taken.
lite-brite: Taken.
coloring book: Taken.
small heart shaped locket: Taken.
small hobby horse: Taken.

>f
Seaside Path
You are on the seaside path.  Backwards from here is The Land of Unrealized Possibilities.  Forward is The Land of Unlaunched Vessels.

* * *

>f
The Path Around the Liquor Store
You're on the path around the liquor store.  You see the side of the liquor store on one side and a fence on the other side.

>f
The Land in Front of the Liquor Store
The Land in Front of the Liquor Store looks mostly abandoned, and you feel a slight sense of disappointment and dread here.  The liquor store is closed, looks like permanently, and there's just a weird kiddie ride here.  There are marks on the sidewalk where some other metal vending machines were, but it looks like they've been carted away.  Only the kiddie ride remains.  It's pretty depressing here, but if you continue to go forward, the Idyllic Path leads to The Land of Puppy Cardiovascular health, which is the superior place.

You can see a kiddie ride here.

>insert block into kiddie ride
It won't fit.  It's not a coin.

* * *

>f
The Land of Unlaunched Vessels II: The Launchening
You are in The Land of Unlaunched Vessels II: The Launchening.  There is a launchpad here, on which sits a large, 1950's era rocket in galaxy white and candy-apple red. The Sequel Path leads backwards towards The Land of Unlaunched Vessels.  Ahead of you, The Anticlimactic Path probably leads somewhere really amazing.

You can see a launchpad and a rocket here.

>look
The Land of Unlaunched Vessels II: The Launchening
You are in The Land of Unlaunched Vessels II: The Launchening.  There is a launchpad here, on which sits a large, 1950's era rocket in galaxy white and candy-apple red. The Sequel Path leads backwards towards The Land of Unlaunched Vessels.  Ahead of you, The Anticlimactic Path probably leads somewhere really amazing.

You can see a launchpad and a rocket here.

* * *

>f
Seaside Path
You are on the seaside path.  Backwards from here is The Land of Unrealized Possibilities.  Forward is The Land of Unlaunched Vessels.

>get page
You carefully tear the last page out.  It's actually perforated, so you don't feel so bad.

* * *

>get all
wooden block: Taken.
skinny naked plastic doll: Taken.
closed jack-in-the-box: Taken.
lite-brite: Taken.
coloring book: Taken.
small heart shaped locket: Taken.
small hobby horse: Taken.

>plug lite
What do you want to plug the lite-brite into?

>plug book
What do you want to plug the coloring book into?

>plug book into lite
You can only plug in things that have a power cord, and the coloring book doesn't.

>plug lite
What do you want to plug the lite-brite into?

>plug lite into book
The coloring book wasn't made to have anything plugged into it.

* * *

>get all
wooden block: Taken.
skinny naked plastic doll: Taken.
closed jack-in-the-box: Taken.
lite-brite: Taken.
coloring book: Taken.
small heart shaped locket: Taken.
small hobby horse: Taken.

>unplug lite
The lite-brite is already unplugged.

>unplug cord
You can only plug in and unplug things that have a power cord.

>f
Seaside Path
You are on the seaside path.  Backwards from here is The Land of Unrealized Possibilities.  Forward is The Land of Unlaunched Vessels.

* * *

>f
The Land in Front of the Liquor Store
The Land in Front of the Liquor Store looks mostly abandoned, and you feel a slight sense of disappointment and dread here.  The liquor store is closed, looks like permanently, and there's just a weird kiddie ride here.  There are marks on the sidewalk where some other metal vending machines were, but it looks like they've been carted away.  Only the kiddie ride remains.  It's pretty depressing here, but if you continue to go forward, the Idyllic Path leads to The Land of Puppy Cardiovascular health, which is the H.

You can see a kiddie ride here.

>look ride
Off to the side a little ways is a mechanical kiddie ride.  It's a big (to a child) yellow humvee with cartoon human eyes where the headlights should be.  It's anchored to a diamond plate platform and looks to have stopped mid-tilt.

Mounted on a post next to it is a coin box showing the coin denomination necessary to make it run: 25, or one U.S. quarter dollar piece.

There were once two of these rides outside every grocery store in America.  Whether they died out because kids collectively realized they weren't fun, or just liability, you're surprised to see this one here.  It's plugged into a commercial outlet in the liquor store wall.

The kiddie ride is currently switched off.

>look plug
You can't see any such thing.

>unplug kiddie ride
You pull the industrial strength cord out of the liquor store wall.

>look
The Land in Front of the Liquor Store
The Land in Front of the Liquor Store looks mostly abandoned, and you feel a slight sense of disappointment and dread here.  The liquor store is closed, looks like permanently, and there's just a weird kiddie ride here.  There are marks on the sidewalk where some other metal vending machines were, but it looks like they've been carted away.  Only the kiddie ride remains.  It's pretty depressing here, but if you continue to go forward, the Idyllic Path leads to The Land of Puppy Cardiovascular health, which is the H.

You can see a kiddie ride here.

>look ride
Off to the side a little ways is a mechanical kiddie ride.  It's a big (to a child) yellow humvee with cartoon human eyes where the headlights should be.  It's anchored to a diamond plate platform and looks to have stopped mid-tilt.

Mounted on a post next to it is a coin box showing the coin denomination necessary to make it run: 25, or one U.S. quarter dollar piece.

There were once two of these rides outside every grocery store in America.  Whether they died out because kids collectively realized they weren't fun, or just liability, you're surprised to see this one here.  It's unplugged.

The kiddie ride is currently switched off.

>plug kiddie ride
What do you want to plug the kiddie ride into?

>outlet
The commercial outlet wasn't made to have anything plugged into it.

>plug kiddie ride into commercial outlet
The commercial outlet wasn't made to have anything plugged into it.

* * *

>open box
You open the toy box, revealing a wooden block, a skinny naked plastic doll, a closed jack-in-the-box, a lite-brite, a coloring book, a small heart shaped locket, and a small hobby horse.

>get block
Taken.

>play with block
It's just one block.  It's possibly the single most boring toy imaginable by itself.

>play with doll
Taken.

You twist the doll into a few unlikely positions, as if getting ready to horrify an imaginary younger sister.  Then, you are bored and bend her back to her awkwardly stiff standing pose.

>play with rocket
You can't see any such thing.

>play with box
You did.  You are good at entertaining yourself.

>play with lite
You'd need the pegs, and to be able to plug it in.

>play with coloring book
You don't have anything to color with, but you run your finger over one of the already-colored pages and pretend for a little while.

>f
Seaside Path
You are on the seaside path.  Backwards from here is The Land of Unrealized Possibilities.  Forward is The Land of Unlaunched Vessels.

* * *

>f
The Land of Unlaunched Vessels II: The Launchening
You are in The Land of Unlaunched Vessels II: The Launchening.  There is a launchpad here, on which sits a large, 1950's era rocket in galaxy white and candy-apple red. The Sequel Path leads backwards towards The Land of Unlaunched Vessels.  Ahead of you, The Anticlimactic Path probably leads somewhere really amazing.

You can see a launchpad and a rocket here.

>open hatch
You open the hatch.

>enter
You must supply a noun.

>enter rocket
You pull yourself into the rocket.

The Inside of the Parked Rocket
You are within the smooth walls of the rocket.  It is very plain here, out the porthole window you can see the sky, and out the hatch you can see The Land of Unlaunched Vessels II: The Launchening.

You can see a cockpit, a big metal unit containing a captain's chair and a control panel here.

>look through porthole
The porthole window, at the moment, allows you a good view of the featureless sky above The Land of Unlaunched Vessels II: The Launchening.

>look porthole
The porthole window, at the moment, allows you a good view of the featureless sky above The Land of Unlaunched Vessels II: The Launchening.

>look out porthole
The porthole window, at the moment, allows you a good view of the featureless sky above The Land of Unlaunched Vessels II: The Launchening.

>look through
What do you want to look through?

>look through window
The porthole window, at the moment, allows you a good view of the featureless sky above The Land of Unlaunched Vessels II: The Launchening.

>swim
There isn't any water nearby.

* * *

>drop jack
Dropped.

>get jack in the box
Taken.

>drop box
The toy box is already here.

>open jack
You grasp the little wooden ball and begin to turn the crank as you hold the jack-in-the-box steady.  A dark little tune plinks its way out, echoing forth from the little tin box.  It's not "all around the mulberry bush" or any song you recognize, so you don't quite expect it when its last note ends, and the spring-loaded doll within leaps out with surprising agility.  You jump a tiny bit, in spite of yourself.  The devil doll looks pleased.

For some reason, the crack of the jack-in-the-box opening unnerves your brother.  He leaps up from the couch for a moment. "Quit it, you craphead," your brother snarls.  He gives you an extremely intense look and lays back on the couch.

>look jack
The jack-in-the-box is a brightly painted tin cube, and actually looks to be some sort of antique.  It is detailed with flames, and written on the back and front are the words "diable en bote".  Its tin lid is popped open, revealing a small fabric devil puppet.

>look jack-in-the-box
(the open jack-in-the-box)
The jack-in-the-box is a brightly painted tin cube, and actually looks to be some sort of antique.  It is detailed with flames, and written on the back and front are the words "diable en bote".  Its tin lid is popped open, revealing a small fabric devil puppet.

>restart
Are you sure you want to restart?

Please answer yes or no.

>yes
Some would say that life is like a box of metaphors.  I would not say that.  I would say life is a land of metaphors.  You come to this land perhaps from a hidden door in the back of a piece of furniture, perhaps from a door in a dream.  Either way, you find yourself here.

The Land of Breakfast and Lunch
~ a land can contain both ~ by Daniel Talsky
Release 5 / Serial number 200321 / Inform 7 build 6M62 (I6/v6.34 lib 6/12N) SD

The Path
You are at the beginning of a path.  It is plain, even homely.  It leads forward towards The Land of Breakfast and Lunch.  If you "walk forward" you will follow the path.

* * *

I beg your pardon?

>look porthole
The graphene solar system hangs like a jewel in the distance.  It is partially obscured by several deep orbits worth of space junk.  Bands of the junk thousands of miles wide wrap in orbit around some planets, as well as the entire solar system.  It is, in its own way, breathtaking.  Behind it is a curtain of stars.

>press forward
Whoosh.  You thought maybe the engine engaged again, but something else already did.  It bent space softly around you, and, maybe the rocket moved a little.  Like with a soft whoosh.  It happened in less than a second.  Now, you think you're somewhere else.

Chrysocolla Cluster
You are inside the rocket as it cruises very slowly through the deep, dark void of space.  Outside the porthole window is the deep, dark void of space covered over with a curtain of stars.

You notice something unusual outside the porthole window.

>press land
You can't see any such thing.

* * *

>press return
Whoosh. At the end of the rocket's soft whoosh, its mighty engines begin to engage, slowing its fall as it pillows down to the landing pad in The Land of Once Launched Vessels.

The Inside of the Parked Rocket
You are within the smooth walls of the rocket.  It is very plain here, out the porthole window you can see the sky, and out the hatch you can see The Land of Once Launched Vessels.

>get out
You exit the hatch opening and climb to the ground.

The Land of Once Launched Vessels
You are in The Land of Once Launched Vessels.  There is a launchpad here, on which sits a large, 1950's era rocket in galaxy white and candy-apple red. The Spiritual Sequel Path leads backwards towards The Land of Unlaunched Vessels

You can see a launchpad and a Rocket here.

>s
The Spiritual Sequel Path
You are on the the sequel path.  Backwards from here is The Land of Unlaunched Vessels.  Forward is The Land of Once Launched Vessels.

>s
The Land of Unlaunched Vessels
You are in the The Land of Unlaunched Vessels.  You stand near the edge of the bay, and there is a sailing ship moored here with thick and aged ropes tied to a bollard.  The Hopeful Path leads backward towards The Land of Unrealized Possibilities, a place you're not sure you want to be.  Forward, The Spiritual Sequel Path leads to The Land of Once Launched Vessels.

You can see an a swarthy hippie seaperson here.

>s
Seaside Path
You are on the the seaside path.  Backwards from here is The Land of Unrealized Possibilities.  Forward is The Land of Unlaunched Vessels.

>restart
Are you sure you want to restart?

>yes
Some would say that life is like a box of metaphors.  I would not say that.  I would say life is a land of metaphors.  You come to this land perhaps from a hidden door in the back of a piece of furniture, perhaps from a door in a dream.  Either way, you find yourself here.

The Land of Breakfast and Lunch
~ a land can contain both ~ by Daniel Talsky
Release 5 / Serial number 200321 / Inform 7 build 6M62 (I6/v6.34 lib 6/12N) SD

The Path
You are at the beginning of a path.  It is plain, even homely.  It leads forward towards The Land of Breakfast and Lunch.  If you "walk forward" you will follow the path.

I beg your pardon?

>f
The Land of Breakfast and Lunch
The Land of Breakfast and Lunch is a lot smaller than you were expecting.  It's actually just a small clearing near the road, like a roadside stop, with a painted picnic table containing a simple but nourishing breakfast on one end, and a simple but nourishing lunch on the other end.  A stubby little path leads backwards, and the path continues forward, towards The Land of Unrealized Possibilities.  If you "walk forward" or just "forward" or even just "f" you will be walking towards it.

You can see a painted picnic table (on which are Breakfast and Lunch) here.

>look
The Land of Breakfast and Lunch
The Land of Breakfast and Lunch is a lot smaller than you were expecting.  It's actually just a small clearing near the road, like a roadside stop, with a painted picnic table containing a simple but nourishing breakfast on one end, and a simple but nourishing lunch on the other end.  A stubby little path leads backwards, and the path continues forward, towards The Land of Unrealized Possibilities.  If you "walk forward" or just "forward" or even just "f" you will be walking towards it.

You can see a painted picnic table (on which are Breakfast and Lunch) here.

>look antipasto
This is an antique bakelite tray containing an assortment of little foods: several different kinds of olives, marinated artichoke hearts, fresh figs, grilled vegetable slices, and cornichon.

>look tray
This is an antique bakelite tray containing an assortment of little foods: several different kinds of olives, marinated artichoke hearts, fresh figs, grilled vegetable slices, and cornichon.

>look tray of antipasto
This is an antique bakelite tray containing an assortment of little foods: several different kinds of olives, marinated artichoke hearts, fresh figs, grilled vegetable slices, and cornichon.

>look lunch
(Lunch)
Lunch is made up of a grilled cheese sandwich, a bowl of tomato soup, a small tray of antipasto, and a ramekin filled with a very enticing potato salad.

>look tray
This is an antique bakelite tray containing an assortment of little foods: several different kinds of olives, marinated artichoke hearts, fresh figs, grilled vegetable slices, and cornichon.

* * *

>f
The Land of Breakfast and Lunch
The Land of Breakfast and Lunch is a lot smaller than you were expecting.  It's actually just a small clearing near the road, like a roadside stop, with a painted picnic table containing a simple but nourishing breakfast on one end, and a simple but nourishing lunch on the other end.  A stubby little path leads backwards, and the path continues forward, towards The Land of Unrealized Possibilities.  If you "walk forward" or just "forward" or even just "f" you will be walking towards it.

You can see a painted picnic table (on which are Breakfast and Lunch) here.

* * *

>look antipasto
You can't see any such thing.

>look tray
You can't see any such thing.

>look tray of antipasto
You can't see any such thing.

>look lunch
(Lunch)
Lunch is made up of a grilled cheese sandwich, a bowl of tomato soup, a small tray of antipasto, and a ramekin filled with a very enticing potato salad.

>look tray
You can't see any such thing.

* * *

>get locket
Taken.

>look locket
It is a small pewter locket.  It looks a bit old fashioned.  It has a small clasp on the side and looks like you could easily open it.

>open locket
You open the small heart shaped locket, revealing a faded picture of a child who looks a lot like you.

>look locket
It is a small pewter locket.  It looks a bit old fashioned.  LOCKET IS OPEN

In the small heart shaped locket is a faded picture of a child who looks a lot like you.

* * *

>get locket
Taken.

>wear locket
You put on the small heart shaped locket.

>i
You are carrying:
  a small heart shaped locket (being worn, and closed)

>b
Hopeful Path
You are on the hopeful path.  Backwards from here is The Land of Breakfast and Lunch.  Forward is The Land of Unrealized Possibilities.

* * *

>eat lunch
(Lunch)
It doesn't really seem appropriate to just start eating lunch with a perfectly good breakfast sitting there at the same table.  Besides, you're really more in the mood for breakfast.

I beg your pardon?

>walk
You'll have to say which compass direction to go in.

* * *

>get locket
Taken.

>x locke
You can't see any such thing.

>x locket
It is a small pewter locket.  It looks a bit old fashioned.  It has a small clasp on the side and looks like you could easily open it.

>open locket
You open the small heart shaped locket, revealing a faded picture of a child who looks a lot like you.

>look locket
It is a small pewter locket.  It looks a bit old fashioned.  The locket has been opened on its tiny hinge.

In the small heart shaped locket is a faded picture of a child who looks a lot like you.

>take picture
Taken.

>look locket
It is a small pewter locket.  It looks a bit old fashioned.  The locket has been opened on its tiny hinge.  On the metal surface behind the picture is a tiny, engraved heart.

* * *

>open box
You open the toy box, revealing a wooden block, a skinny naked plastic doll, a closed jack-in-the-box, a lite-brite, a coloring book, a small heart shaped locket, and a small hobby horse.

>look crank
A wire hand crank with a small wooden ball as a handle on the end.

>look jack-in-the-box
The jack-in-the-box is a brightly painted tin cube, and actually looks to be some sort of antique.  It is detailed with flames, and written on the back and front are the words "diable en bote".  It has a tightly fitted lid on top, and a small wire and wood hand crank on one side.

>open lid
Which do you mean, the closed tin lid or the hinged wooden lid?

>close tin lid
It's already tightly closed.

>open tin lid
It's tightly closed.  You'd open it by turning the crank.

>look crank
A wire hand crank with a small wooden ball as a handle on the end.

>twist crank
You grasp the little wooden ball and begin to turn the crank as you hold the jack-in-the-box steady.  A dark little tune plinks its way out, echoing forth from the little tin box.  It's not "all around the mulberry bush" or any song you recognize, so you don't quite expect it when its last note ends, and the spring-loaded doll within leaps out with surprising agility.  You jump a tiny bit, in spite of yourself.  The devil doll looks pleased.

>look box
(the toy box)
It is a large simple wooden toy box stained with a nice hand-painted varnish.  It has a hinged lid on top.

In the toy box are a wooden block, a skinny naked plastic doll, a lite-brite, a coloring book, a small heart shaped locket, and a small hobby horse.

>look jack-in-the-box
(the open jack-in-the-box)
The jack-in-the-box is a brightly painted tin cube, and actually looks to be some sort of antique.  It is detailed with flames, and written on the back and front are the words "diable en bote".  Its tin lid is popped open, revealing a small fabric devil puppet.

>turn crank
You can turn the crank, but the jack-in-the-box is already out-of-the-box.

* * *

>open box
You open the toy box, revealing a wooden block, a skinny naked plastic doll, a closed jack-in-the-box, a lite-brite, a coloring book, a small heart shaped locket, and a small hobby horse.

>look jack
The jack-in-the-box is a brightly painted tin cube, and actually looks to be some sort of antique.  It is detailed with flames, and written on the back and front are the words "diable en bote".  It has a tightly fitted lid on top, and a small wire and wood hand crank on one side.

>look wire
The crank is a piece of thick wire bent twice.

>look crank
A wire hand crank with a small wooden ball as a handle on the end.

>look ball
A wooden ball attached to the crank acts as a free-rotating handle for the crank.

* * *

>open box
You open the toy box, revealing a wooden block, a skinny naked plastic doll, a closed jack-in-the-box, a lite-brite, a coloring book, a small heart shaped locket, and a small hobby horse.

>open locket
You open the small heart shaped locket, revealing a faded picture of a child who looks a lot like you.

>get block
Taken.

>put block in locket
The locket is quite small.

You put the wooden block into the small heart shaped locket.

* * *

>open locket
You open the small heart shaped locket, revealing a faded picture of a child who looks a lot like you.

>get photo
Taken.

* * *

I beg your pardon?

>look locket
It is a small pewter locket.  It looks a bit old fashioned.  It has a small clasp on the side and looks like you could easily open it.

>look photo
You don't remember ever seeing any picture of you like this photo, but this one looks almost exactly other pictures of you at about three.  There is a smile that's a mix of sadness and joy on the child's face.  When you look at it, you can almost feel the feeling.

>i
You are carrying:
  a faded picture of a child who looks a lot like you

* * *

I beg your pardon?

>put block into locket
The locket is quite small.

* * *

>get picture
Taken.

>put block in locket
The locket is quite small.

* * *

>get picture
Taken.

>put picture in locket
You put the faded picture of a child who looks a lot like you into the small heart shaped locket.

>look locket
It is a small pewter locket.  It looks a bit old fashioned.  It has a small clasp on the side and looks like you could easily open it.

In the small heart shaped locket is a faded picture of a child who looks a lot like you.

>s
Hopeful Path
You are on the hopeful path.  Backwards from here is The Land of Breakfast and Lunch.  Forward is The Land of Unrealized Possibilities.

* * *

>eat breakfast
(Breakfast)
You sit down for a moment and eat breakfast.  It is delicious but you still don't quite feel satisfied.

* * *

>look dishes
Which do you mean, the breakfast dishes or the lunch dishes?

>look breakfast dishes
You've politely stacked the breakfast dishes, so the table doesn't look too messy.

>look room
You can't see any such thing.

>x
(the painted picnic table)
It's a well-maintained picnic table painted in a bright, childish, civic style, depicting a crude sun with huge yellow beams bathing jagged pine trees in their light.

>look room
You can't see any such thing.

>look
The Land of Breakfast and Lunch
The Land of Breakfast and Lunch is a lot smaller than you were expecting.  It's actually just a small clearing near the road, like a roadside stop, with a painted picnic table containing a the empty dishes from a simple but nourishing breakfast on one end, and the dishes of a simple but nourishing lunch on the other end.  A stubby little path leads backwards, and the path continues forward, towards The Land of Unrealized Possibilities.  If you "walk forward" or just "forward" or even just "f" you will be walking towards it.

You can see a painted picnic table here.

* * *

>open locket
You open the small heart shaped locket, revealing a faded picture of a child who looks a lot like you.

>put block in locket
The locket is quite small.

* * *

>open locket
You open the small heart shaped locket, revealing a faded picture of a child who looks a lot like you.

>take picture
Taken.

>put picture in locket
You gently slide the locket back in.

>look locket
It is a small pewter locket.  It looks a bit old fashioned.  It has a small clasp on the side and looks like you could easily open it.

>look in locket
The small heart shaped locket is empty.

* * *

>open box
You open the toy box, revealing a wooden block, a skinny naked plastic doll, a closed jack-in-the-box, a lite-brite, a coloring book, a small heart shaped locket, and a small hobby horse.

>play with breasts
C'mon dude.

* * *

>open box
You open the toy box, revealing a wooden block, a skinny naked plastic doll, a closed jack-in-the-box, a lite-brite, a coloring book, a small heart shaped locket, and a small hobby horse.

>throw block
Just like your grandma used to say: you have to be holding the wooden block before you can throw the wooden block.

>get block
Taken.

>throw block
Just like your grandma used to say: you have to be holding the wooden block before you can throw the wooden block.

>i
You examine what you'd normally use to carry things, all the way from fingertip to elbow.  As you suspected, nothing is contained there.  You briefly check for pockets or some kind of fanny pack.  There isn't anything like that.  You are forced to conclude that you have no possessions.

>look
The Land of Unrealized Possibilities
You are in the Land of Unrealized Possibilities.  Just being here gives you a sense of all that could be accomplished if enough time, effort, and focus were pointed in a specific direction.  There is a sense of both excitement and disappointment here that is almost palpable.  The Hopeful Path leads backward towards The Land of Breakfast and Lunch, a place with a much clearer sense of purpose.  The Seaside Path leads forward, towards The Land of Unlaunched Vessels.

You can see a wooden block, a toy box (in which are a skinny naked plastic doll, a closed jack-in-the-box, a lite-brite (empty), a coloring book, a small heart shaped locket (closed), and a small hobby horse), a couch (on which is your brother), and a TV here.

>throw coloring book
Just like your grandma used to say: you have to be holding the coloring book before you can throw the coloring book.

>throw couch
Just like your grandma used to say: you have to be holding the couch before you can throw the couch.

* * *

>f
The Land of Unrealized Possibilities
You are in the Land of Unrealized Possibilities.  Just being here gives you a sense of all that could be accomplished if enough time, effort, and focus were pointed in a specific direction.  There is a sense of both excitement and disappointment here that is almost palpable.  The Hopeful Path leads backward towards The Land of Breakfast and Lunch, a place with a much clearer sense of purpose.  The Seaside Path leads forward, towards The Land of Unlaunched Vessels.

You can see a toy box (closed), a couch (on which is your brother), and a TV here.

>open lid
You open the toy box, revealing a wooden block, a skinny naked plastic doll, a closed jack-in-the-box, a lite-brite, a coloring book, a small heart shaped locket, and a small hobby horse.

* * *

>f
The Land of Unrealized Possibilities
You are in the Land of Unrealized Possibilities.  Just being here gives you a sense of all that could be accomplished if enough time, effort, and focus were pointed in a specific direction.  There is a sense of both excitement and disappointment here that is almost palpable.  The Hopeful Path leads backward towards The Land of Breakfast and Lunch, a place with a much clearer sense of purpose.  The Seaside Path leads forward, towards The Land of Unlaunched Vessels.

You can see a toy box (closed), a couch (on which is your brother), and a TV here.

>ride brother
The mental picture is pretty funny, but you are 100% certain your brother is not going to find it funny.

>kick brother
I only understood you as far as wanting to kick.

>sit on couch
Your brother gives you a quick, dirty look that reminds you he's ready to back it up with the kind of painful violence that will not leave a mark.

>hit brother
Your brother nearly-psychically determines your intention. In a flash, he socks you in the quadricep with precision and speed.  He hits what you realize is an existing bruise from last time and you have to take deep breaths to keep from doubling over in pain.   "What's your problem, you aggro dipwad?" he says, distractedly, eyes still on the TV.

>hug brother
A swift wave of nausea dissuades you.

* * *

>ride brother
The mental picture is pretty funny, but you are 100% certain your brother is not going to find it funny.

>sit couch
I didn't understand that sentence.

>sit on the couch
Your brother gives you a quick, dirty look that you know he's ready to back up with violence.

>get on the couch
Your brother gives you a quick, dirty look that you know he's ready to back up with violence.

>ride couch
Your brother gives you a quick, dirty look that you know he's ready to back up with violence.

* * *

>f
The Land of Unrealized Possibilities
You are in the Land of Unrealized Possibilities.  Just being here gives you a sense of all that could be accomplished if enough time, effort, and focus were pointed in a specific direction.  There is a sense of both excitement and disappointment here that is almost palpable.  The Hopeful Path leads backward towards The Land of Breakfast and Lunch, a place with a much clearer sense of purpose.  The Seaside Path leads forward, towards The Land of Unlaunched Vessels.

You can see a toy box (closed), a couch (on which is your brother), and a TV here.

>swim
There isn't any water nearby.

>f
Seaside Path
You are on the seaside path.  Backwards from here is The Land of Unrealized Possibilities.  Forward is The Land of Unlaunched Vessels.

>swim
There isn't any water nearby.

>f
The Land of Unlaunched Vessels
You are in The Land of Unlaunched Vessels.  You stand near the edge of the bay, and there is a sailing ship moored here with thick and aged ropes tied to a bollard.  The Hopeful Path leads backward towards The Land of Unrealized Possibilities, a place you're not sure you want to be.  Forward, Sequel Path leads to The Land of Unlaunched Vessels II: The Launchening.

You can see a swarthy hippie seaperson here.

>swim
You don't want to get wet, and you don't think you'd be able to get on the fluyt that way, or really be able to do much of anything all wet and swimming around.

* * *

>f
The Land of Unrealized Possibilities
You are in the Land of Unrealized Possibilities.  Just being here gives you a sense of all that could be accomplished if enough time, effort, and focus were pointed in a specific direction.  There is a sense of both excitement and disappointment here that is almost palpable.  The Hopeful Path leads backward towards The Land of Breakfast and Lunch, a place with a much clearer sense of purpose.  The Seaside Path leads forward, towards The Land of Unlaunched Vessels.

You can see a toy box (closed), a couch (on which is your brother), and a TV here.

>talk to brother
To start a conversation, try to ASK your brother ABOUT something or TELL your brother ABOUT something.

* * *

>f
The Land of Unrealized Possibilities
You are in the Land of Unrealized Possibilities.  Just being here gives you a sense of all that could be accomplished if enough time, effort, and focus were pointed in a specific direction.  There is a sense of both excitement and disappointment here that is almost palpable.  The Hopeful Path leads backward towards The Land of Breakfast and Lunch, a place with a much clearer sense of purpose.  The Seaside Path leads forward, towards The Land of Unlaunched Vessels.

You can see a toy box (closed), a couch (on which is your brother), and a TV here.

>tickle brother
Your brother nearly-psychically determines your intention. In a flash, he socks you in the quadricep with precision and speed.  He hits what you realize is an existing bruise from last time and you have to take deep breaths to keep from doubling over in pain.   "What's your problem, you aggro dipwad?" he says, distractedly, eyes still on the TV.

>f
Seaside Path
You are on the seaside path.  Backwards from here is The Land of Unrealized Possibilities.  Forward is The Land of Unlaunched Vessels.

* * *

>f
The Land of Unlaunched Vessels
You are in The Land of Unlaunched Vessels.  You stand near the edge of the bay, and there is a sailing ship moored here with thick and aged ropes tied to a bollard.  The Hopeful Path leads backward towards The Land of Unrealized Possibilities, a place you're not sure you want to be.  Forward, Sequel Path leads to The Land of Unlaunched Vessels II: The Launchening.

You can see a swarthy hippie seaperson here.

>tickle brother
You can't see any such thing.

>s
Seaside Path
You are on the seaside path.  Backwards from here is The Land of Unrealized Possibilities.  Forward is The Land of Unlaunched Vessels.

>s
The Land of Unrealized Possibilities
You are in the Land of Unrealized Possibilities.  Just being here gives you a sense of all that could be accomplished if enough time, effort, and focus were pointed in a specific direction.  There is an sense of both excitement and disappointment here that is almost palpable.  The Hopeful Path leads backward towards The Land of Breakfast and Lunch, a place with a much clearer sense of purpose.

You can see a toy box (closed), a couch (on which is your brother), and a TV here.

I beg your pardon?

>tickle brother
Your brother has been on the planet a little longer than you, and he isn't tricked by your simple attacks.  He uses a simple karate chop to the solar plexus and you have to fight the urge to barf for one moment.

>kick brother
Your brother has been on the planet a little longer than you, and he isn't tricked by your simple attacks.  He uses a simple karate chop to the solar plexus and you have to fight the urge to barf for one moment.

* * *

>f
The Land of Unrealized Possibilities
You are in the Land of Unrealized Possibilities.  Just being here gives you a sense of all that could be accomplished if enough time, effort, and focus were pointed in a specific direction.  There is a sense of both excitement and disappointment here that is almost palpable.  The Hopeful Path leads backward towards The Land of Breakfast and Lunch, a place with a much clearer sense of purpose.  The Seaside Path leads forward, towards The Land of Unlaunched Vessels.

You can see a toy box (closed), a couch (on which is your brother), and a TV here.

>turn off tv
C'mon, Farts McJohnson, I'm watching this.

* * *

>f
The Land of Unrealized Possibilities
You are in the Land of Unrealized Possibilities.  Just being here gives you a sense of all that could be accomplished if enough time, effort, and focus were pointed in a specific direction.  There is a sense of both excitement and disappointment here that is almost palpable.  The Hopeful Path leads backward towards The Land of Breakfast and Lunch, a place with a much clearer sense of purpose.  The Seaside Path leads forward, towards The Land of Unlaunched Vessels.

You can see a toy box (closed), a couch (on which is your brother), and a TV here.

>watch tv
An early 35" flatscreen.  Bulky, black, and plastic.  It lived in your den for way too long, just because no one wanted to lift it.  It's odd to see it here, in The Land of Unrealized Possibilities.  It is showing "The Walter Dormouse Chronicles" on channel 37.

>watch tv
An early 35" flatscreen.  Bulky, black, and plastic.  It lived in your den for way too long, just because no one wanted to lift it.  It's odd to see it here, in The Land of Unrealized Possibilities.  It is showing "Punky Brewster" on channel 31.

>watch tv
An early 35" flatscreen.  Bulky, black, and plastic.  It lived in your den for way too long, just because no one wanted to lift it.  It's odd to see it here, in The Land of Unrealized Possibilities.  It is showing "Stupid, Stupid Baby (1998)" on channel 41.

>watch tv
An early 35" flatscreen.  Bulky, black, and plastic.  It lived in your den for way too long, just because no one wanted to lift it.  It's odd to see it here, in The Land of Unrealized Possibilities.  It is showing "How I Got in a Non-Hierarchical Triad with your Mother" on channel 21.

>watch tv
An early 35" flatscreen.  Bulky, black, and plastic.  It lived in your den for way too long, just because no one wanted to lift it.  It's odd to see it here, in The Land of Unrealized Possibilities.  It is showing "Darkwing Duck" on channel 10.

>watch tv
An early 35" flatscreen.  Bulky, black, and plastic.  It lived in your den for way too long, just because no one wanted to lift it.  It's odd to see it here, in The Land of Unrealized Possibilities.  It is showing "The Beige Man Group" on channel 17.

>watch tv
An early 35" flatscreen.  Bulky, black, and plastic.  It lived in your den for way too long, just because no one wanted to lift it.  It's odd to see it here, in The Land of Unrealized Possibilities.  It is showing "Samual McSamualson Rides Again" on channel 24.

>watch tv
An early 35" flatscreen.  Bulky, black, and plastic.  It lived in your den for way too long, just because no one wanted to lift it.  It's odd to see it here, in The Land of Unrealized Possibilities.  It is showing "Rad Fights VII (1984)" on channel 22.

>watch tv
An early 35" flatscreen.  Bulky, black, and plastic.  It lived in your den for way too long, just because no one wanted to lift it.  It's odd to see it here, in The Land of Unrealized Possibilities.  It is showing "ABRAXIS Live" on channel 27.

>watch tv
An early 35" flatscreen.  Bulky, black, and plastic.  It lived in your den for way too long, just because no one wanted to lift it.  It's odd to see it here, in The Land of Unrealized Possibilities.  It is showing "Enraged Juggalos" on channel 13.

>watch tv
An early 35" flatscreen.  Bulky, black, and plastic.  It lived in your den for way too long, just because no one wanted to lift it.  It's odd to see it here, in The Land of Unrealized Possibilities.  It is showing "Bills and Bennies" on channel 32.

>watch tv
An early 35" flatscreen.  Bulky, black, and plastic.  It lived in your den for way too long, just because no one wanted to lift it.  It's odd to see it here, in The Land of Unrealized Possibilities.  It is showing "Gorgon: The Magnificent" on channel 16.

>watch tv
An early 35" flatscreen.  Bulky, black, and plastic.  It lived in your den for way too long, just because no one wanted to lift it.  It's odd to see it here, in The Land of Unrealized Possibilities.  It is showing "The Beige Man Group" on channel 17.

>watch tv
An early 35" flatscreen.  Bulky, black, and plastic.  It lived in your den for way too long, just because no one wanted to lift it.  It's odd to see it here, in The Land of Unrealized Possibilities.  It is showing "Access Hollywoo" on channel 20.

>watch tv
An early 35" flatscreen.  Bulky, black, and plastic.  It lived in your den for way too long, just because no one wanted to lift it.  It's odd to see it here, in The Land of Unrealized Possibilities.  It is showing "The Walter Dormouse Chronicles" on channel 37.

>watch tv
An early 35" flatscreen.  Bulky, black, and plastic.  It lived in your den for way too long, just because no one wanted to lift it.  It's odd to see it here, in The Land of Unrealized Possibilities.  It is showing "The Walter Dormouse Chronicles" on channel 37.

>watch tv
An early 35" flatscreen.  Bulky, black, and plastic.  It lived in your den for way too long, just because no one wanted to lift it.  It's odd to see it here, in The Land of Unrealized Possibilities.  It is showing "Song of Ire and Spice" on channel 39.

>watch tv
An early 35" flatscreen.  Bulky, black, and plastic.  It lived in your den for way too long, just because no one wanted to lift it.  It's odd to see it here, in The Land of Unrealized Possibilities.  It is showing "How I Got in a Non-Hierarchical Triad with your Mother" on channel 21.

>watch tv
An early 35" flatscreen.  Bulky, black, and plastic.  It lived in your den for way too long, just because no one wanted to lift it.  It's odd to see it here, in The Land of Unrealized Possibilities.  It is showing "+/- (2006)" on channel 36.

>watch tv
An early 35" flatscreen.  Bulky, black, and plastic.  It lived in your den for way too long, just because no one wanted to lift it.  It's odd to see it here, in The Land of Unrealized Possibilities.  It is showing "Thundercats" on channel 11.

>watch tv
An early 35" flatscreen.  Bulky, black, and plastic.  It lived in your den for way too long, just because no one wanted to lift it.  It's odd to see it here, in The Land of Unrealized Possibilities.  It is showing "Borderline Personality Island" on channel 19.

>watch tv
An early 35" flatscreen.  Bulky, black, and plastic.  It lived in your den for way too long, just because no one wanted to lift it.  It's odd to see it here, in The Land of Unrealized Possibilities.  It is showing "Dangerous Food of the Ganges" on channel 26.

>watch tv
An early 35" flatscreen.  Bulky, black, and plastic.  It lived in your den for way too long, just because no one wanted to lift it.  It's odd to see it here, in The Land of Unrealized Possibilities.  It is showing "Beauty and the Embolism" on channel 25.

>watch tv
An early 35" flatscreen.  Bulky, black, and plastic.  It lived in your den for way too long, just because no one wanted to lift it.  It's odd to see it here, in The Land of Unrealized Possibilities.  It is showing "Bedside (1997)" on channel 35.

>watch tv
An early 35" flatscreen.  Bulky, black, and plastic.  It lived in your den for way too long, just because no one wanted to lift it.  It's odd to see it here, in The Land of Unrealized Possibilities.  It is showing "Punky Brewster" on channel 31.

>watch tv
An early 35" flatscreen.  Bulky, black, and plastic.  It lived in your den for way too long, just because no one wanted to lift it.  It's odd to see it here, in The Land of Unrealized Possibilities.  It is showing "Punky Brewster" on channel 31.

>watch tv
An early 35" flatscreen.  Bulky, black, and plastic.  It lived in your den for way too long, just because no one wanted to lift it.  It's odd to see it here, in The Land of Unrealized Possibilities.  It is showing "Buck Rogers" on channel 12.

>watch tv
An early 35" flatscreen.  Bulky, black, and plastic.  It lived in your den for way too long, just because no one wanted to lift it.  It's odd to see it here, in The Land of Unrealized Possibilities.  It is showing "Thundercats" on channel 11.

>watch tv
An early 35" flatscreen.  Bulky, black, and plastic.  It lived in your den for way too long, just because no one wanted to lift it.  It's odd to see it here, in The Land of Unrealized Possibilities.  It is showing "Trial of Jetsy Watson" on channel 33.

>watch tv
An early 35" flatscreen.  Bulky, black, and plastic.  It lived in your den for way too long, just because no one wanted to lift it.  It's odd to see it here, in The Land of Unrealized Possibilities.  It is showing "Samual McSamualson Rides Again" on channel 24.

>watch tv
An early 35" flatscreen.  Bulky, black, and plastic.  It lived in your den for way too long, just because no one wanted to lift it.  It's odd to see it here, in The Land of Unrealized Possibilities.  It is showing "Wet Planet IV" on channel 14.

>watch tv
An early 35" flatscreen.  Bulky, black, and plastic.  It lived in your den for way too long, just because no one wanted to lift it.  It's odd to see it here, in The Land of Unrealized Possibilities.  It is showing "Bedside (1997)" on channel 35.

>watch tv
An early 35" flatscreen.  Bulky, black, and plastic.  It lived in your den for way too long, just because no one wanted to lift it.  It's odd to see it here, in The Land of Unrealized Possibilities.  It is showing "Speed Burners (1975)" on channel 29.

>watch tv
An early 35" flatscreen.  Bulky, black, and plastic.  It lived in your den for way too long, just because no one wanted to lift it.  It's odd to see it here, in The Land of Unrealized Possibilities.  It is showing "The Treinta y Ocho" on channel 38.

>watch tv
An early 35" flatscreen.  Bulky, black, and plastic.  It lived in your den for way too long, just because no one wanted to lift it.  It's odd to see it here, in The Land of Unrealized Possibilities.  It is showing "Thundercats" on channel 11.

>watch tv
An early 35" flatscreen.  Bulky, black, and plastic.  It lived in your den for way too long, just because no one wanted to lift it.  It's odd to see it here, in The Land of Unrealized Possibilities.  It is showing "Dangerous Food of the Ganges" on channel 26.

>watch tv
An early 35" flatscreen.  Bulky, black, and plastic.  It lived in your den for way too long, just because no one wanted to lift it.  It's odd to see it here, in The Land of Unrealized Possibilities.  It is showing "Speed Burners (1975)" on channel 29.

>watch tv
An early 35" flatscreen.  Bulky, black, and plastic.  It lived in your den for way too long, just because no one wanted to lift it.  It's odd to see it here, in The Land of Unrealized Possibilities.  It is showing "Darkwing Duck" on channel 10.

>watch tv
An early 35" flatscreen.  Bulky, black, and plastic.  It lived in your den for way too long, just because no one wanted to lift it.  It's odd to see it here, in The Land of Unrealized Possibilities.  It is showing "Botswana (1992)" on channel 15.

>watch tv
An early 35" flatscreen.  Bulky, black, and plastic.  It lived in your den for way too long, just because no one wanted to lift it.  It's odd to see it here, in The Land of Unrealized Possibilities.  It is showing "ABRAXIS Live" on channel 27.

>watch tv
An early 35" flatscreen.  Bulky, black, and plastic.  It lived in your den for way too long, just because no one wanted to lift it.  It's odd to see it here, in The Land of Unrealized Possibilities.  It is showing "Trial of Jetsy Watson" on channel 33.

>watch tv
An early 35" flatscreen.  Bulky, black, and plastic.  It lived in your den for way too long, just because no one wanted to lift it.  It's odd to see it here, in The Land of Unrealized Possibilities.  It is showing "How I Got in a Non-Hierarchical Triad with your Mother" on channel 21.

>watch tv
An early 35" flatscreen.  Bulky, black, and plastic.  It lived in your den for way too long, just because no one wanted to lift it.  It's odd to see it here, in The Land of Unrealized Possibilities.  It is showing "Song of Ire and Spice" on channel 39.

>watch tv
An early 35" flatscreen.  Bulky, black, and plastic.  It lived in your den for way too long, just because no one wanted to lift it.  It's odd to see it here, in The Land of Unrealized Possibilities.  It is showing "Delta Farce (2001)" on channel 30.

>watch tv
An early 35" flatscreen.  Bulky, black, and plastic.  It lived in your den for way too long, just because no one wanted to lift it.  It's odd to see it here, in The Land of Unrealized Possibilities.  It is showing "The Beige Man Group" on channel 17.

>watch tv
An early 35" flatscreen.  Bulky, black, and plastic.  It lived in your den for way too long, just because no one wanted to lift it.  It's odd to see it here, in The Land of Unrealized Possibilities.  It is showing "Thundercats" on channel 11.

>watch tv
An early 35" flatscreen.  Bulky, black, and plastic.  It lived in your den for way too long, just because no one wanted to lift it.  It's odd to see it here, in The Land of Unrealized Possibilities.  It is showing "Wet Planet IV" on channel 14.

>watch tv
An early 35" flatscreen.  Bulky, black, and plastic.  It lived in your den for way too long, just because no one wanted to lift it.  It's odd to see it here, in The Land of Unrealized Possibilities.  It is showing "Rad Fights VII (1984)" on channel 22.

>watch tv
An early 35" flatscreen.  Bulky, black, and plastic.  It lived in your den for way too long, just because no one wanted to lift it.  It's odd to see it here, in The Land of Unrealized Possibilities.  It is showing "Access Hollywoo" on channel 20.

>watch tv
An early 35" flatscreen.  Bulky, black, and plastic.  It lived in your den for way too long, just because no one wanted to lift it.  It's odd to see it here, in The Land of Unrealized Possibilities.  It is showing "Beauty and the Embolism" on channel 25.

>watch tv
An early 35" flatscreen.  Bulky, black, and plastic.  It lived in your den for way too long, just because no one wanted to lift it.  It's odd to see it here, in The Land of Unrealized Possibilities.  It is showing "Gorgon: The Magnificent" on channel 16.

>watch tv
An early 35" flatscreen.  Bulky, black, and plastic.  It lived in your den for way too long, just because no one wanted to lift it.  It's odd to see it here, in The Land of Unrealized Possibilities.  It is showing "Stupid, Stupid Baby (1998)" on channel 41.

>watch tv
An early 35" flatscreen.  Bulky, black, and plastic.  It lived in your den for way too long, just because no one wanted to lift it.  It's odd to see it here, in The Land of Unrealized Possibilities.  It is showing "+/- (2006)" on channel 36.

>watch tv
An early 35" flatscreen.  Bulky, black, and plastic.  It lived in your den for way too long, just because no one wanted to lift it.  It's odd to see it here, in The Land of Unrealized Possibilities.  It is showing "Enraged Juggalos" on channel 13.

>watch tv
An early 35" flatscreen.  Bulky, black, and plastic.  It lived in your den for way too long, just because no one wanted to lift it.  It's odd to see it here, in The Land of Unrealized Possibilities.  It is showing "Botswana (1992)" on channel 15.

>watch tv
An early 35" flatscreen.  Bulky, black, and plastic.  It lived in your den for way too long, just because no one wanted to lift it.  It's odd to see it here, in The Land of Unrealized Possibilities.  It is showing "Delta Farce (2001)" on channel 30.

>watch tv
An early 35" flatscreen.  Bulky, black, and plastic.  It lived in your den for way too long, just because no one wanted to lift it.  It's odd to see it here, in The Land of Unrealized Possibilities.  It is showing "Bills and Bennies" on channel 32.

>watch tv
An early 35" flatscreen.  Bulky, black, and plastic.  It lived in your den for way too long, just because no one wanted to lift it.  It's odd to see it here, in The Land of Unrealized Possibilities.  It is showing "The Walter Dormouse Chronicles" on channel 37.

>watch tv
An early 35" flatscreen.  Bulky, black, and plastic.  It lived in your den for way too long, just because no one wanted to lift it.  It's odd to see it here, in The Land of Unrealized Possibilities.  It is showing "Bedside (1997)" on channel 35.

>watch tv
An early 35" flatscreen.  Bulky, black, and plastic.  It lived in your den for way too long, just because no one wanted to lift it.  It's odd to see it here, in The Land of Unrealized Possibilities.  It is showing "Wet Planet IV" on channel 14.

>watch tv
An early 35" flatscreen.  Bulky, black, and plastic.  It lived in your den for way too long, just because no one wanted to lift it.  It's odd to see it here, in The Land of Unrealized Possibilities.  It is showing "That 20's Show" on channel 40.

>watch tv
An early 35" flatscreen.  Bulky, black, and plastic.  It lived in your den for way too long, just because no one wanted to lift it.  It's odd to see it here, in The Land of Unrealized Possibilities.  It is showing "Rad Fights VII (1984)" on channel 22.

* * *

>f
The Land of Unrealized Possibilities
You are in the Land of Unrealized Possibilities.  Just being here gives you a sense of all that could be accomplished if enough time, effort, and focus were pointed in a specific direction.  There is a sense of both excitement and disappointment here that is almost palpable.  The Hopeful Path leads backward towards The Land of Breakfast and Lunch, a place with a much clearer sense of purpose.  The Seaside Path leads forward, towards The Land of Unlaunched Vessels.

You can see a toy box (closed), a couch (on which is your brother), and a TV here.

>x tv
An early 35" flatscreen.  Bulky, black, and plastic.  It lived in your den for way too long, just because no one wanted to lift it.  It's odd to see it here, in The Land of Unrealized Possibilities.  It is playing Thundercats.

>x tv
An early 35" flatscreen.  Bulky, black, and plastic.  It lived in your den for way too long, just because no one wanted to lift it.  It's odd to see it here, in The Land of Unrealized Possibilities.  It is playing Darkwing Duck.

>x tv
An early 35" flatscreen.  Bulky, black, and plastic.  It lived in your den for way too long, just because no one wanted to lift it.  It's odd to see it here, in The Land of Unrealized Possibilities.  It is playing The Beige Man Group.

>x tv
An early 35" flatscreen.  Bulky, black, and plastic.  It lived in your den for way too long, just because no one wanted to lift it.  It's odd to see it here, in The Land of Unrealized Possibilities.  It is playing Darkwing Duck.

>x tv
An early 35" flatscreen.  Bulky, black, and plastic.  It lived in your den for way too long, just because no one wanted to lift it.  It's odd to see it here, in The Land of Unrealized Possibilities.  It is playing Buck Rogers.

>x tv
An early 35" flatscreen.  Bulky, black, and plastic.  It lived in your den for way too long, just because no one wanted to lift it.  It's odd to see it here, in The Land of Unrealized Possibilities.  It is playing Buck Rogers.

>x tv
An early 35" flatscreen.  Bulky, black, and plastic.  It lived in your den for way too long, just because no one wanted to lift it.  It's odd to see it here, in The Land of Unrealized Possibilities.  It is playing Thundercats.

>x tv
An early 35" flatscreen.  Bulky, black, and plastic.  It lived in your den for way too long, just because no one wanted to lift it.  It's odd to see it here, in The Land of Unrealized Possibilities.  It is playing Buck Rogers.

>x tv
An early 35" flatscreen.  Bulky, black, and plastic.  It lived in your den for way too long, just because no one wanted to lift it.  It's odd to see it here, in The Land of Unrealized Possibilities.  It is playing Gorgon: The Magnificent.

>x tv
An early 35" flatscreen.  Bulky, black, and plastic.  It lived in your den for way too long, just because no one wanted to lift it.  It's odd to see it here, in The Land of Unrealized Possibilities.  It is playing Blue Planet IV.

>x tv
An early 35" flatscreen.  Bulky, black, and plastic.  It lived in your den for way too long, just because no one wanted to lift it.  It's odd to see it here, in The Land of Unrealized Possibilities.  It is playing The Beige Man Group.

>x tv
An early 35" flatscreen.  Bulky, black, and plastic.  It lived in your den for way too long, just because no one wanted to lift it.  It's odd to see it here, in The Land of Unrealized Possibilities.  It is playing The Beige Man Group.

* * *

>x tv
An early 35" flatscreen.  Bulky, black, and plastic.  It lived in your den for way too long, just because no one wanted to lift it.  It's odd to see it here, in The Land of Unrealized Possibilities.  It is playing Buck Rogers.

>x tv
An early 35" flatscreen.  Bulky, black, and plastic.  It lived in your den for way too long, just because no one wanted to lift it.  It's odd to see it here, in The Land of Unrealized Possibilities.  It is playing Blue Planet IV.

>x tv
An early 35" flatscreen.  Bulky, black, and plastic.  It lived in your den for way too long, just because no one wanted to lift it.  It's odd to see it here, in The Land of Unrealized Possibilities.  It is playing The Great Snafu (1956).

>x tv
An early 35" flatscreen.  Bulky, black, and plastic.  It lived in your den for way too long, just because no one wanted to lift it.  It's odd to see it here, in The Land of Unrealized Possibilities.  It is playing Darkwing Duck.

>x tv
An early 35" flatscreen.  Bulky, black, and plastic.  It lived in your den for way too long, just because no one wanted to lift it.  It's odd to see it here, in The Land of Unrealized Possibilities.  It is playing Gorgon: The Magnificent.

>x tv
An early 35" flatscreen.  Bulky, black, and plastic.  It lived in your den for way too long, just because no one wanted to lift it.  It's odd to see it here, in The Land of Unrealized Possibilities.  It is playing Botswana (1992).

>x tv
An early 35" flatscreen.  Bulky, black, and plastic.  It lived in your den for way too long, just because no one wanted to lift it.  It's odd to see it here, in The Land of Unrealized Possibilities.  It is playing Buck Rogers.

* * *

>x tv
An early 35" flatscreen.  Bulky, black, and plastic.  It lived in your den for way too long, just because no one wanted to lift it.  It's odd to see it here, in The Land of Unrealized Possibilities.  It is playing Blue Planet IV.

>x tv
An early 35" flatscreen.  Bulky, black, and plastic.  It lived in your den for way too long, just because no one wanted to lift it.  It's odd to see it here, in The Land of Unrealized Possibilities.  It is playing Gorgon: The Magnificent.

>x tv
An early 35" flatscreen.  Bulky, black, and plastic.  It lived in your den for way too long, just because no one wanted to lift it.  It's odd to see it here, in The Land of Unrealized Possibilities.  It is playing Thundercats.

* * *

>x tv
An early 35" flatscreen.  Bulky, black, and plastic.  It lived in your den for way too long, just because no one wanted to lift it.  It's odd to see it here, in The Land of Unrealized Possibilities.  It is playing Buck Rogers.

>x tv
An early 35" flatscreen.  Bulky, black, and plastic.  It lived in your den for way too long, just because no one wanted to lift it.  It's odd to see it here, in The Land of Unrealized Possibilities.  It is playing Botswana (1992).

>x tv
An early 35" flatscreen.  Bulky, black, and plastic.  It lived in your den for way too long, just because no one wanted to lift it.  It's odd to see it here, in The Land of Unrealized Possibilities.  It is playing Enraged Juggalos.

>x tv
An early 35" flatscreen.  Bulky, black, and plastic.  It lived in your den for way too long, just because no one wanted to lift it.  It's odd to see it here, in The Land of Unrealized Possibilities.  It is playing Gorgon: The Magnificent.

>x tv
An early 35" flatscreen.  Bulky, black, and plastic.  It lived in your den for way too long, just because no one wanted to lift it.  It's odd to see it here, in The Land of Unrealized Possibilities.  It is playing The Beige Man Group.

>x tv
An early 35" flatscreen.  Bulky, black, and plastic.  It lived in your den for way too long, just because no one wanted to lift it.  It's odd to see it here, in The Land of Unrealized Possibilities.  It is playing Botswana (1992).

* * *

>f
Hopeful Path
You are on the hopeful path.  Backwards from here is The Land of Breakfast and Lunch.  Forward is The Land of Unrealized Possibilities.

>get locket
You can't see any such thing.

>f
The Land of Unrealized Possibilities
You are in the Land of Unrealized Possibilities.  Just being here gives you a sense of all that could be accomplished if enough time, effort, and focus were pointed in a specific direction.  There is an sense of both excitement and disappointment here that is almost palpable.  The Hopeful Path leads backward towards The Land of Breakfast and Lunch, a place with a much clearer sense of purpose.

You can see a toy box (closed), a couch (on which is your brother), and a TV here.

>open box
You open the toy box, revealing a wooden block, a small heart shaped locket, and a small hobby horse.

* * *

>open locket
You open the small heart shaped locket, revealing a faded picture of a child who looks a lot like you.

>get photo
You can't see any such thing.

>get picture
Taken.

>put picture in locket
You gently slide the locket back in.

You put the faded picture of a child who looks a lot like you into the small heart shaped locket.

* * *

>f
Hopeful Path
You are on the hopeful path.  Backwards from here is The Land of Breakfast and Lunch.  Forward is The Land of Unrealized Possibilities.

>look
Hopeful Path
You are on the hopeful path.  Backwards from here is The Land of Breakfast and Lunch.  Forward is The Land of Unrealized Possibilities.

>f
The Land of Unrealized Possibilities
You are in the Land of Unrealized Possibilities.  Just being here gives you a sense of all that could be accomplished if enough time, effort, and focus were pointed in a specific direction.  There is a sense of both excitement and disappointment here that is almost palpable.  The Hopeful Path leads backward towards The Land of Breakfast and Lunch, a place with a much clearer sense of purpose.  The Seaside Path leads forward, towards The Land of Unlaunched Vessels.

You can see a toy box (closed), a couch (on which is your brother), and a TV here.

* * *

>get all
wooden block: Taken.
skinny naked plastic doll: Taken.
closed jack-in-the-box: Taken.
lite-brite: Taken.
coloring book: Taken.
small heart shaped locket: Taken.
small hobby horse: Taken.

>plug jack into lite
You can only plug in things that have a power cord.

>unplug jack from lite
You can only plug in and unplug things that have a power cord.

>unplug jack
What do you want to unplug the closed jack-in-the-box from?

>unplug jack from lite
You can only plug in and unplug things that have a power cord.

* * *

>f
Hopeful Path
You are on the hopeful path.  Backwards from here is The Land of Breakfast and Lunch.  Forward is The Land of Unrealized Possibilities.

>look brother
You can't see any such thing.

>f
The Land of Unrealized Possibilities
You are in the Land of Unrealized Possibilities.  Just being here gives you a sense of all that could be accomplished if enough time, effort, and focus were pointed in a specific direction.  There is an sense of both excitement and disappointment here that is almost palpable.  The Hopeful Path leads backward towards The Land of Breakfast and Lunch, a place with a much clearer sense of purpose.

You can see a toy box (closed), a couch (on which is your brother), and a TV here.

>look brother
Your brother is a lean masterpiece of laziness and force.  He is devoted to his wasting of time right now and has himself wedged into the couch like a part of it. He is watching TV, and frequently changing the channel.

>brother, jump
your brother has better things to do.

>bro, jump
your brother has better things to do.

>attack brother
Your brother nearly-psychically determines your intention. In a flash, he socks you in the quadricep with precision and speed.  He hits what you realize is an existing bruise from last time and you have to take deep breaths to keep from doubling over in pain.   "What's your problem, you aggro dipwad?" he says, distractedly, eyes still on the TV.

>attack brother
Your brother has been on the planet a little longer than you, and he isn't tricked by your simple attacks.  He uses a simple karate chop to the solar plexus and you have to fight the urge to barf for one moment.

>attack brother
Your brother has been on the planet a little longer than you, and he isn't tricked by your simple attacks.  He uses a simple karate chop to the solar plexus and you have to fight the urge to barf for one moment.

>turn knob
"C'mon, Farts McJohnson," your brother says, wearily, "I'm watching this."

* * *

>f
Hopeful Path
You are on the hopeful path.  Backwards from here is The Land of Breakfast and Lunch.  Forward is The Land of Unrealized Possibilities.

>n
The Land of Unrealized Possiblities
You are in the Land of Unrealized Possibilities.  Just being here gives you a sense of all that could be accomplished if enough time, effort, and focus were pointed in a specific direction.  There is an sense of both excitement and disappointment here that is almost palpable.  The Hopeful Path leads backward towards The Land of Breakfast and Lunch, a place with a much clearer sense of purpose.

You can see a toy box (closed) here.

>n
You can't go that way.

* * *

>f
Hopeful Path
You are on the hopeful path.  Backwards from here is The Land of Breakfast and Lunch.  Forward is The Land of Unrealized Possibilities.

>open jack
You can't see any such thing.

>f
The Land of Unrealized Possibilities
You are in the Land of Unrealized Possibilities.  Just being here gives you a sense of all that could be accomplished if enough time, effort, and focus were pointed in a specific direction.  There is a sense of both excitement and disappointment here that is almost palpable.  The Hopeful Path leads backward towards The Land of Breakfast and Lunch, a place with a much clearer sense of purpose.  The Seaside Path leads forward, towards The Land of Unlaunched Vessels.

You can see a toy box (closed), a couch (on which is your brother), and a TV here.

* * *

>open box
You open the toy box, revealing a wooden block, a skinny naked plastic doll, a closed jack-in-the-box, a lite-brite, a coloring book, a small heart shaped locket, and a small hobby horse.

>turn crank
You grasp the little wooden ball and begin to turn the crank as you hold the jack-in-the-box steady.  A dark little tune plinks its way out, echoing forth from the little tin box.  It's not "all around the mulberry bush" or any song you recognize, so you don't quite expect it when its last note ends, and the spring-loaded doll within leaps out with surprising agility.  You jump a tiny bit, in spite of yourself.  The devil doll looks pleased.

For some reason, the crack of the jack-in-the-box opening unnerves your brother.  He leaps up from the couch for a moment. "Quit it, you craphead," your brother snarls.  He gives you an extremely intense look and lays back on the couch.

>look doll
Which do you mean, the skinny naked plastic doll or the devil doll?

* * *

>f
Hopeful Path
You are on the hopeful path.  Backwards from here is The Land of Breakfast and Lunch.  Forward is The Land of Unrealized Possibilities.

>ride kiddie ride
You can't see any such thing.

>f
The Land of Unrealized Possibilities
You are in the Land of Unrealized Possibilities.  Just being here gives you a sense of all that could be accomplished if enough time, effort, and focus were pointed in a specific direction.  There is an sense of both excitement and disappointment here that is almost palpable.  The Hopeful Path leads backward towards The Land of Breakfast and Lunch, a place with a much clearer sense of purpose.

You can see a toy box (closed), a couch (on which is your brother), a TV, and a kiddie ride here.

>ride kiddie ride
You can't ride stuff like that, silly.

>get on kiddie ride
That's not something you can enter.

* * *

>look breakfast
(Breakfast)
Breakfast consists of a halved grapefruit with the membranes cut for easier eating, a soft-boiled egg in a specially designed holder, and a bowl of Lieutenant Chomp with a small pitcher of milk next to it.

>look lunch
(Lunch)
Lunch is made up of a grilled cheese sandwich, a bowl of tomato soup, a small tray of antipasto, and a ramekin filled with a very enticing potato salad.

>look soup
Warm, creamy, and comforting, about two thirds the way to filling a fiestaware bowl.  There is a bit of coarsely cracked pepper at the top.

* * *

>look dishes
Which do you mean, the breakfast dishes or the lunch dishes?

>breakfast
They are keeping the breakfast from just sitting on the table.

>look dishes
Which do you mean, the breakfast dishes or the lunch dishes?

>lunch
They are keeping the lunch from just sitting on the table.

>eat breakfast
(Breakfast)
You sit down for a moment and eat breakfast.  It is delicious but you still don't quite feel satisfied.

>look dishes
Which do you mean, the breakfast dishes or the lunch dishes?

* * *

>lunch
They are keeping the lunch from just sitting on the table.

>look dishes
Which do you mean, the breakfast dishes or the lunch dishes?

>breakfast
You've politely stacked the breakfast dishes, so the table doesn't look too messy.

>get dishes
Which do you mean, the breakfast dishes or the lunch dishes?

>breakfast
That's hardly portable.

* * *

>look egg
The soft-boiled egg is a prim and underappreciated breakfast item.  Sure, it's a lot of work to get to all the egg, but it's a very delicate experience.  You would take the nearby small spoon and gently crack the top of the egg off, exposing the soft and rich partially-cooked egg inside.

>eat breakfast
(Breakfast)
You sit down for a moment and eat breakfast.  It is delicious but you still don't quite feel satisfied.

* * *

>look egg
You can't see any such thing.

>look lunch
(Lunch)
Lunch is made up of a grilled cheese sandwich, a bowl of tomato soup, a small tray of antipasto, and a ramekin filled with a very enticing potato salad.

* * *

>look soup
Warm, creamy, and comforting, about two thirds the way to filling a fiestaware bowl.  There is a bit of coarsely cracked pepper at the top.

>eat lunch
(Lunch)
Lunch was wonderful.  Your stomach feels like a puzzle, where the final piece has finally been snapped into place.  You now feel as if you could take on the world.

>eat soup
You can't see any such thing.

>eat dishes
Which do you mean, the breakfast dishes or the lunch dishes?

>lunch
That's plainly inedible.

>f
Hopeful Path
You are on the hopeful path.  Backwards from here is The Land of Breakfast and Lunch.  Forward is The Land of Unrealized Possiblities.

>f
The Land of Unrealized Possiblities
You are in the Land of Unrealized Possibilities.  Just being here gives you a sense of all that could be accomplished if enough time, effort, and focus were pointed in a specific direction.  There is an sense of both excitement and disappointment here that is almost palpable.  The Hopeful Path leads backward towards The Land of Breakfast and Lunch, a place with a much clearer sense of purpose.

You can see a toy box (closed), a couch (on which is your brother), and a TV here.

>sit couch
I didn't understand that sentence.

>sit on couch
Your brother is utilizing so much of the couch, you don't see a good place to sit without pissing him off.

* * *

>look grass
It's grassy.  And brownish.

* * *

>look lunch
(Lunch)
Lunch is made up of a grilled cheese sandwich, a bowl of tomato soup, a small tray of antipasto, and a ramekin filled with a very enticing potato salad.

>f
Hopeful Path
You are on the hopeful path.  Backwards from here is The Land of Breakfast and Lunch.  Forward is The Land of Unrealized Possibilities.

* * *

>f
The Land of Unrealized Possibilities
You are in the Land of Unrealized Possibilities.  Just being here gives you a sense of all that could be accomplished if enough time, effort, and focus were pointed in a specific direction.  There is an sense of both excitement and disappointment here that is almost palpable.  The Hopeful Path leads backward towards The Land of Breakfast and Lunch, a place with a much clearer sense of purpose.

You can see a toy box (closed), a couch (on which is your brother), a TV, and a kiddie ride here.

>f
Seaside Path
You are on the the seaside path.  Backwards from here is The Land of Unrealized Possibilities.  Forward is The Land of Unlaunched Vessels.

* * *

>open hatch
You open the hatch.

>get in rocket
You pull yourself into the rocket.

The Inside of the Parked Rocket
You are within the smooth walls of the rocket.  It is very plain here, out the porthole window you can see The Land of Unlaunched Vessels II: The Launchening.

You can see a the cockpit, a big metal unit containing a captain's chair and a control panel here.

>press red button
You're too hungry to go to space.

* * *

>look sun
It's a well-maintained picnic table painted in a bright, childish, civic style, depicting a crude sun with huge yellow beams bathing jagged pine trees in their light.

On the painted picnic table are Breakfast and Lunch.

>eat breakfast
You sit down for a moment and eat breakfast.  It is delicious but you still don't quite feel satisfied.

>eat lunch
Lunch was wonderful.  Your stomach feels like a puzzle, where the final piece has finally been snapped into place.  You now feel as if you could take on the world.

>look
The Land of Breakfast and Lunch
The Land of Breakfast and Lunch is a lot smaller than you were expecting.  It's actually just a small clearing near the road, like a roadside stop, with a painted picnic table containing a simple but nourishing breakfast on one end, and a simple but nourishing lunch on the other end.  A stubby little path leads backwards, and the path continues forward, towards The Land of Unrealized Possibilities.  If you "walk forward" or just "forward" or even just "f" you will be walking towards it.

You can see a painted picnic table here.

* * *

>look under table
The grass underneath is getting a bit brown.

* * *

>push table
The painted picnic table is super heavy and it doesn't seem worth it.

>pull table
The painted picnic table is super heavy and it doesn't seem worth it.

* * *

>retreat
Path
You are at the beginning of a path.  It is plain, even homely.  It leads forward towards The Land of Breakfast and Lunch.  If you "walk forward" you will follow the path.

>take off shirt
You can't see any such thing.

* * *

>sit at table
I didn't understand that sentence.

>sit on table
That's not something you can sit down on.

* * *

>sit on table
You get onto the painted picnic table.

On the painted picnic table you can see Breakfast and Lunch.

>get up
You get off the painted picnic table.

The Land of Breakfast and Lunch
The Land of Breakfast and Lunch is a lot smaller than you were expecting.  It's actually just a small clearing near the road, like a roadside stop, with a painted picnic table containing a simple but nourishing breakfast on one end, and a simple but nourishing lunch on the other end.  A stubby little path leads backwards, and the path continues forward, towards The Land of Unrealized Possibilities.  If you "walk forward" or just "forward" or even just "f" you will be walking towards it.

You can see a painted picnic table (on which are Breakfast and Lunch) here.

* * *

>sit table
I didn't understand that sentence.

>sit on table
You ease on to one of the benches.

The Land of Breakfast and Lunch (on the painted picnic table)
The Land of Breakfast and Lunch is a lot smaller than you were expecting.  It's actually just a small clearing near the road, like a roadside stop, with a painted picnic table containing a simple but nourishing breakfast on one end, and a simple but nourishing lunch on the other end.  A stubby little path leads backwards, and the path continues forward, towards The Land of Unrealized Possibilities.  If you "walk forward" or just "forward" or even just "f" you will be walking towards it.

On the painted picnic table you can see Breakfast and Lunch.

>f
(first getting off the painted picnic table)

Hopeful Path
You are on the hopeful path.  Backwards from here is The Land of Breakfast and Lunch.  Forward is The Land of Unrealized Possiblities.

* * *

>smell potato
Smells like smoked paprika and mustard.

* * *

>taste potato
Lunch is kind of an all-or-nothing affair.  One really needs to sit down and tuck into it, rather than simply nibbling at one thing or another and leaving the rest of it to repel and disgust another traveller.

* * *

>x
(the painted picnic table)
It's a well-maintained picnic table painted in a bright, childish, civic style, depicting a crude sun with huge yellow beams bathing jagged pine trees in their light.

On the painted picnic table are Breakfast and Lunch.

>look breakfast
Breakfast consists of a halved grapefruit with the membranes cut for easier eating, a soft-boiled egg in a specially designed holder, and a bowl of Lieutenant Chomp with a small pitcher of milk next to it.

>look
The Land of Breakfast and Lunch
The Land of Breakfast and Lunch is a lot smaller than you were expecting.  It's actually just a small clearing near the road, like a roadside stop, with a painted picnic table containing a simple but nourishing breakfast on one end, and a simple but nourishing lunch on the other end.  A stubby little path leads backwards, and the path continues forward, towards The Land of Unrealized Possibilities.  If you "walk forward" or just "forward" or even just "f" you will be walking towards it.

You can see a painted picnic table (on which are Breakfast and Lunch) here.

>eat brakfast
You can't see any such thing.

>eat breakfast
You sit down for a moment and eat breakfast.  It is delicious but you still don't quite feel satisfied.

>look
The Land of Breakfast and Lunch
The Land of Breakfast and Lunch is a lot smaller than you were expecting.  It's actually just a small clearing near the road, like a roadside stop, with a painted picnic table containing a the empty dishes from a simple but nourishing breakfast on one end, and the a simple but nourishing lunch on the other end.  A stubby little path leads backwards, and the path continues forward, towards The Land of Unrealized Possibilities.  If you "walk forward" or just "forward" or even just "f" you will be walking towards it.

You can see a painted picnic table (on which is Lunch) here.

>look dishes
You can't see any such thing.

* * *

>x breakfast
Breakfast consists of a halved grapefruit with the membranes cut for easier eating, a soft-boiled egg in a specially designed holder, and a bowl of Lieutenant Chomp with a small pitcher of milk next to it.

>smell grapefruit
Smells pretty much like grapefruit.

* * *

>follow path
The Land of Breakfast and Lunch
The Land of Breakfast and Lunch is a lot smaller than you were expecting.  It's actually just a small clearing near the road, like a roadside stop, with a painted picnic table containing a simple but nourishing breakfast on one end, and a simple but nourishing lunch on the other end.  A stubby little path leads backwards, and the path continues forward, towards The Land of Unrealized Possibilities.  If you "walk forward" or just "forward" or even just "f" you will be walking towards it.

You can see a painted picnic table (on which are Breakfast and Lunch) here.

>follow path
Hopeful Path
You are on the hopeful path.  Backwards from here is The Land of Breakfast and Lunch.  Forward is The Land of Unrealized Possibilities.

>follow path
The Land of Unrealized Possibilities
You are in the Land of Unrealized Possibilities.  Just being here gives you a sense of all that could be accomplished if enough time, effort, and focus were pointed in a specific direction.  There is an sense of both excitement and disappointment here that is almost palpable.  The Hopeful Path leads backward towards The Land of Breakfast and Lunch, a place with a much clearer sense of purpose.

You can see a toy box (closed), a couch (on which is your brother), and a TV here.

>follow path
Seaside Path
You are on the the seaside path.  Backwards from here is The Land of Unlaunched Vessels.  Forward is The Land of Unlaunched Vessels.

>follow path
The Land of Unlaunched Vessels
You are in the The Land of Unlaunched Vessels.  You stand near the edge of the bay, and there is a vessel moored here with thick and aged ropes tied to a bollard.  The Hopeful Path leads backward towards The Land of Unrealized Possibilities, a place you're not sure you want to be.

You can see an a swarthy hippie seaperson here.

>follow path
You don't know to a certainty how to go forward in this situation.

* * *

>forward
The Land of Breakfast and Lunch
The Land of Breakfast and Lunch is a lot smaller than you were expecting.  It's actually just a small clearing near the road, like a roadside stop, with a painted picnic table containing a simple but nourishing breakfast on one end, and a simple but nourishing lunch on the other end.  A stubby little path leads backwards, and the path continues forward, towards The Land of Unrealized Possibilities.  If you "walk forward" or just "forward" or even just "f" you will be walking towards it.

You can see a painted picnic table (on which are Breakfast and Lunch) here.

>f
That's not a verb I recognize.

* * *

>go back
Path
You are at the beginning of a path.  It is plain, even homely.  It leads forward towards The Land of Breakfast and Lunch.  If you "walk forward" you will follow the path.

* * *

>help
The Land of Breakfast and Lunch is a little place for you to walk around in and look at every little detail. There are a couple of little tricky things you can accomplish, but there's really no point other than to look at everything and smell everything and laugh at my dumb little jokes.  Sometimes people don't notice the toy box in The Land of Unrealized Possiblities.  Sometimes people don't realize you can "open hatch" and "enter rocket" when you're near the 1950"s rocket.  Yes, there's one little puzzle and it involves the jack-in-the-box, but don't get too concerned about it.  If you need any other help you can just email me at danieltalsky@gmail.com.  I'm happy to help.

>into
That's not a verb I recognize.

>info
The Land of Breakfast and Lunch is a little place for you to walk around in and look at every little detail. There are a couple of little tricky things you can accomplish, but there's really no point other than to look at everything and smell everything and laugh at my dumb little jokes.  Sometimes people don't notice the toy box in The Land of Unrealized Possiblities.  Sometimes people don't realize you can "open hatch" and "enter rocket" when you're near the 1950"s rocket.  Yes, there's one little puzzle and it involves the jack-in-the-box, but don't get too concerned about it.  If you need any other help you can just email me at danieltalsky@gmail.com.  I'm happy to help.

>hints
The Land of Breakfast and Lunch is a little place for you to walk around in and look at every little detail. There are a couple of little tricky things you can accomplish, but there's really no point other than to look at everything and smell everything and laugh at my dumb little jokes.  Sometimes people don't notice the toy box in The Land of Unrealized Possiblities.  Sometimes people don't realize you can "open hatch" and "enter rocket" when you're near the 1950"s rocket.  Yes, there's one little puzzle and it involves the jack-in-the-box, but don't get too concerned about it.  If you need any other help you can just email me at danieltalsky@gmail.com.  I'm happy to help.

>f
The Land of Breakfast and Lunch
The Land of Breakfast and Lunch is a lot smaller than you were expecting.  It's actually just a small clearing near the road, like a roadside stop, with a painted picnic table containing a simple but nourishing breakfast on one end, and a simple but nourishing lunch on the other end.  A stubby little path leads backwards, and the path continues forward, towards The Land of Unrealized Possibilities.  If you "walk forward" or just "forward" or even just "f" you will be walking towards it.

You can see a painted picnic table (on which are Breakfast and Lunch) here.

* * *

>open box
You open the toy box, revealing a wooden block, a skinny naked plastic doll, a closed jack-in-the-box, a lite-brite, a coloring book, a small heart shaped locket, and a small hobby horse.

>look book
The title of the coloring book reads "Horse Party!"  Inside are drawings of horses in pastoral settings, but with festive party hats.  They are doing no discernible celebrating.  Seems a little demented, really.  A couple of the pictures are colored neatly, and one is very carefully colored, as if by an adult.The last page is black with some kind of glow-in-the-dark ink.

>get page
You carefully tear the last page out.  It's actually perforated, so you don't feel so bad.

>i
You are carrying:
  a last page from the coloring book, black, and printed with some kind of glow-in-the-dark-ink

>look book
The title of the coloring book reads "Horse Party!"  Inside are drawings of horses in pastoral settings, but with festive party hats.  They are doing no discernible celebrating.  Seems a little demented, really.  A couple of the pictures are colored neatly, and one is very carefully colored, as if by an adult.

>i
You are carrying:
  a last page from the coloring book, black, and printed with some kind of glow-in-the-dark-ink

>put page in lite
You put the last page from the coloring book, black, and printed with some kind of glow-in-the-dark-ink into the lite-brite.

>get page
Taken.

>put page in lite
You put the last page from the coloring book, black, and printed with some kind of glow-in-the-dark-ink into the lite-brite.

>look lite
You're looking at a white plastic case with a black plastic pegboard covering one side.   Attached to the back is a black power cord.  If you've seen one before, you know that it's got a little light inside, and usually comes with sheets of black construction paper to affix to the pegboard.  Usually comes with dozens of transparent, colored pegs too.  Push them into the pegboard to make little light-up pictures.  The glow-in-the-dark page of the You don't see any of that stuff though.

In the lite-brite is a last page from the coloring book, black, and printed with some kind of glow-in-the-dark-ink.

* * *

>hep
That's not a verb I recognize.

>help
The Land of Breakfast and Lunch is a little place for you to walk around in and look at every little detail.  There are a couple of little tricky things you can accomplish, but there's really no point other than to look at everything and smell everything and laugh at my dumb little jokes.  Sometimes people don't notice the toy box in The Land of Unrealized Possiblities.  Sometimes people don't realize you can "open hatch" and "enter rocket" when you're near the 1950"s rocket.  Yes, there's one little puzzle and it involves the jack-in-the-box, but don't get too concerned about it.  If you need any other help you can just email me at danieltalsky@gmail.com.  I'm happy to help.

>jump
Ok, this is weird, but for some reason, jumping doesn' appear to work here.  You bend your knees and then shove away from the earth with a snap like you're used to, but your feet don't leave the ground.  It's a little disconcerting, sure, but it doesn't really change your life.

>wait
Time passes.

* * *

>i
Your hands are, like, totally empty. Lame.

>responses
>--> The following sets of responses are available:
    RESPONSES ALL
    RESPONSES 1: Standard Rules

* * *

>f
The Land of Breakfast and Lunch
The Land of Breakfast and Lunch is a lot smaller than you were expecting.  It's actually just a small clearing near the road, like a roadside stop, with a painted picnic table containing a simple but nourishing breakfast on one end, and a simple but nourishing lunch on the other end.  A stubby little path leads backwards, and the path continues forward, towards The Land of Unrealized Possibilities.  If you "walk forward" or just "forward" or even just "f" you will be walking towards it.

You can see a painted picnic table (on which are Breakfast and Lunch) here.

>f
Hopeful Path
You are on the hopeful path.  Backwards from here is The Land of Breakfast and Lunch.  Forward is The Land of Unrealized Possiblities.

>f
The Land of Unrealized Possiblities
You are in the Land of Unrealized Possibilities.  Just being here gives you a sense of all that could be accomplished if enough time, effort, and focus were pointed in a specific direction.  There is an sense of both excitement and disappointment here that is almost palpable.  The Hopeful Path leads backward towards The Land of Breakfast and Lunch, a place with a much clearer sense of purpose.

You can see a toy box (closed) here.

>open box
You open the toy box, revealing a wooden block, a small heart shaped locket, and a small hobby horse.

>look box
It is a large simple wooden toy box stained with a nice hand-painted varnish.  It has a hinged lid on top that you can open.

In the toy box are a wooden block, a small heart shaped locket, and a small hobby horse.

I beg your pardon?

>f
Seaside Path
You are on the the seaside path.  Backwards from here is The Land of Unrealized Possibilities.  Forward is The Land of Launching and Mooring.

>f
The Land of Launching and Mooring
You are in the The Land of Launching and Mooring.  Sometimes a vessel is moored here, and sometimes it isn't.  Currently there is a vessel.  The Hopeful Path leads backward towards The Land of Unrealized Possibilities, a place you'd rather not visit.

* * *

>look brother
You can't see any such thing.

>f
The Land of Breakfast and Lunch
The Land of Breakfast and Lunch is a lot smaller than you were expecting.  It's actually just a small clearing near the road, like a roadside stop, with a painted picnic table containing a simple but nourishing breakfast on one end, and a simple but nourishing lunch on the other end.  A stubby little path leads backwards, and the path continues forward, towards The Land of Unrealized Possibilities.  If you "walk forward" or just "forward" or even just "f" you will be walking towards it.

You can see a painted picnic table (on which are Breakfast and Lunch) here.

* * *

>f
The Land of Unrealized Possiblities
You are in the Land of Unrealized Possibilities.  Just being here gives you a sense of all that could be accomplished if enough time, effort, and focus were pointed in a specific direction.  There is an sense of both excitement and disappointment here that is almost palpable.  The Hopeful Path leads backward towards The Land of Breakfast and Lunch, a place with a much clearer sense of purpose.

You can see a toy box (closed), a couch (on which is your brother), and a TV here.

>look brother
Your brother is a lean masterpiece of laziness and force.  He is devoted to his wasting of time right now and has himself wedged into the couch like a part of it. He is watching TV..

>attack brother
Your brother would kick your ass.

>kick brother
That's not a verb I recognize.

* * *

>look out path
It's a scrubby little path that just kind of tapers off behind you and leads forward towards The Land of Breakfast and Lunch.  If you "walk forward" you'll be following it.

>look through path
You find nothing of interest.

>f
The Land of Breakfast and Lunch
The Land of Breakfast and Lunch is a lot smaller than you were expecting.  It's actually just a small clearing near the road, like a roadside stop, with a painted picnic table containing a simple but nourishing breakfast on one end, and a simple but nourishing lunch on the other end.  A stubby little path leads backwards, and the path continues forward, towards The Land of Unrealized Possibilities.  If you "walk forward" or just "forward" or even just "f" you will be walking towards it.

You can see a painted picnic table (on which are Breakfast and Lunch) here.

* * *

>look path
It's a scrubby little path that just kind of tapers off behind you and leads forward towards The Land of Breakfast and Lunch.  If you "walk forward" you'll be following it.

* * *

>look path
You can't see any such thing.

>f
Hopeful Path
You are on the hopeful path.  Backwards from here is The Land of Breakfast and Lunch.  Forward is The Land of Unrealized Possibilities.

* * *

>look path
It's a meandering path that leads away from The Land of Unrealized Possibilities and it technically beside the sea, but quite far away from it.  As you follow it forward it takes you closer to the sea, as well as The Land of Unlaunched Vessels.

>look sea
The sea is quite a ways away for a path to be called The Seaside Path, but you didn't name it, did you?  Even from here you can see it's not really a sea but some kind of sound or bay.

>f
The Land of Unlaunched Vessels
You are in The Land of Unlaunched Vessels.  You stand near the edge of the bay, and there is a sailing ship moored here with thick and aged ropes tied to a bollard.  The Hopeful Path leads backward towards The Land of Unrealized Possibilities, a place you're not sure you want to be.  Forward, Sequel Path leads to The Land of Unlaunched Vessels II: The Launchening.

You can see a swarthy hippie seaperson here.

* * *

>f
Sequel Path
You are on the sequel path.  Backwards from here is The Land of Unlaunched Vessels.  Forward is The Land of Unlaunched Vessels II: The Launchening.

>look path
You can't see any such thing.

* * *

>look potato
You can't see any such thing.

>f
The Land of Breakfast and Lunch
The Land of Breakfast and Lunch is a lot smaller than you were expecting.  It's actually just a small clearing near the road, like a roadside stop, with a painted picnic table containing a simple but nourishing breakfast on one end, and a simple but nourishing lunch on the other end.  A stubby little path leads backwards, and the path continues forward, towards The Land of Unrealized Possibilities.  If you "walk forward" or just "forward" or even just "f" you will be walking towards it.

You can see a painted picnic table (on which are Breakfast and Lunch) here.

>look potato
It looks like a well-made potato salad, filled with richness and zing.  You can see flecks of red onion and a light dusting of paprika.  In case you don't know what a ramekin is, it's a small straight-walled bowl with scalloped outside walls. Perfect for an attractive presentation of a small potato salad serving.

>smell potato
yo

* * *

>look self
You are a fictional character who looks very much like the non-fictional you looks.  Almost exactly, in fact, except the non-fictional you is slightly more attractive, and the fictional you is a slightly better speller.

>i
You examine what you'd normally use to carry things, all the way from fingertip to elbow.  As you suspected, nothing is contained there.  You briefly check for pockets or some kind of fanny pack.  There isn't anything like that.  You are forced to conclude that you have no possessions.

* * *

>look shrub
You can't see any such thing.

>look path
It's a scrubby little path that just kind of tapers off behind you and leads forward towards The Land of Breakfast and Lunch.  If you "walk forward" you'll be following it.

>look brush
Clusters of scrubby, wild, low shrubbery.  It's the kind of plant that grows where very little else wants to grow.  Like here, at the terminus of this plain path, which is much less interesting than the places it leads.

* * *

>look table
You can't see any such thing.

>f
The Land of Breakfast and Lunch
The Land of Breakfast and Lunch is a lot smaller than you were expecting.  It's actually just a small clearing near the road, like a roadside stop, with a painted picnic table containing a simple but nourishing breakfast on one end, and a simple but nourishing lunch on the other end.  A stubby little path leads backwards, and the path continues forward, towards The Land of Unrealized Possibilities.  If you "walk forward" or just "forward" or even just "f" you will be walking towards it.

You can see a painted picnic table (on which are Breakfast and Lunch) here.

>look table
It's a well-maintained picnic table painted in a bright, childish, civic style, depicting a crude sun with huge yellow beams bathing jagged pine trees in their light.

On the painted picnic table are Breakfast and Lunch.

>eat breakfast
(Breakfast)
You sit down for a moment and eat breakfast.  It is delicious but you still don't quite feel satisfied.

* * *

>eat lunch
(Lunch)
Lunch was wonderful.  Your stomach feels like a puzzle, where the final piece has finally been snapped into place.  You now feel as if you could take on the world.

>look table
It's a well-maintained picnic table painted in a bright, childish, civic style, depicting a crude sun with huge yellow beams bathing jagged pine trees in their light.

* * *

>n
The Land of Breakfast and Lunch
The Land of Breakfast and Lunch is a lot smaller than you were expecting.  It's actually just a small clearing near the road, like a roadside stop, with a painted picnic table containing a simple but nourishing breakfast on one end, and a simple but nourishing lunch on the other end.  A stubby little path leads backwards, and the path continues forward, towards The Land of Unrealized Possibilities.  If you "walk forward" or just "forward" or even just "f" you will be walking towards it.

You can see a painted picnic table (on which are Breakfast and Lunch) here.

>n
Hopeful Path
You are on the hopeful path.  Backwards from here is The Land of Breakfast and Lunch.  Forward is The Land of Unrealized Possiblities.

>n
The Land of Unrealized Possiblities
You are in the Land of Unrealized Possibilities.  Just being here gives you a sense of all that could be accomplished if enough time, effort, and focus were pointed in a specific direction.  There is an sense of both excitement and disappointment here that is almost palpable.  The Hopeful Path leads backward towards The Land of Breakfast and Lunch, a place with a much clearer sense of purpose.

You can see a toy box (closed), a couch (on which is your brother), and a TV here.

>n
Seaside Path
You are on the the seaside path.  Backwards from here is The Land of Unlaunched Vessels.  Forward is The Land of Launching and Mooring.

>look sea
The sea is quite a ways a way for a path to be called The Seaside Path, but  you didn't name it.

* * *

>n
The Land of Unrealized Possiblities
You are in the Land of Unrealized Possibilities.  Just being here gives you a sense of all that could be accomplished if enough time, effort, and focus were pointed in a specific direction.  There is an sense of both excitement and disappointment here that is almost palpable.  The Hopeful Path leads backward towards The Land of Breakfast and Lunch, a place with a much clearer sense of purpose.

You can see a toy box (closed), a couch (on which is your brother), and a TV here.

>open
(the toy box)
You open the toy box, revealing a wooden block, a small heart shaped locket, and a small hobby horse.

>look block
It is a simple block made out of wood.  It is unpainted.  It's the kind of thing you would find at a Montessouri school, usually in the company of many of its compatriots.

>get block
Taken.

>throw block
Dropped.

>i
You examine what you'd normally use to carry things, all the way from fingertip to elbow.  As you suspected, nothing is contained there.  You briefly check for pockets or some kind of fanny pack.  There isn't anything like that.  You are forced to conclude that you have no possessions.

>get block
Taken.

>i
You are carrying:
  a wooden block

>drop
(the wooden block)
Dropped.

>i
You examine what you'd normally use to carry things, all the way from fingertip to elbow.  As you suspected, nothing is contained there.  You briefly check for pockets or some kind of fanny pack.  There isn't anything like that.  You are forced to conclude that you have no possessions.

>look
The Land of Unrealized Possiblities
You are in the Land of Unrealized Possibilities.  Just being here gives you a sense of all that could be accomplished if enough time, effort, and focus were pointed in a specific direction.  There is an sense of both excitement and disappointment here that is almost palpable.  The Hopeful Path leads backward towards The Land of Breakfast and Lunch, a place with a much clearer sense of purpose.

You can see a wooden block and a toy box (in which are a small heart shaped locket (closed) and a small hobby horse) here.

>get locket
Taken.

* * *

>get picture
Taken.

>look picture
You don't remember ever seeing any picture of you like this photo, but this one looks almost exactly other pictures of you at about three.  There is a smile that's a mix of sadness and joy on the child's face.  When you look at it, you can almost feel the feeling.

>i
You are carrying:
  a faded picture of a child who looks a lot like you
  a small heart shaped locket (open but empty)

>close locket
You close the small heart shaped locket.

>push toy box
It is fixed in place.

>look
The Land of Unrealized Possiblities
You are in the Land of Unrealized Possibilities.  Just being here gives you a sense of all that could be accomplished if enough time, effort, and focus were pointed in a specific direction.  There is an sense of both excitement and disappointment here that is almost palpable.  The Hopeful Path leads backward towards The Land of Breakfast and Lunch, a place with a much clearer sense of purpose.

You can see a wooden block and a toy box (in which is a small hobby horse) here.

>get horse
Taken.

>drop horse
Dropped.

>get horse
Taken.

>put horse on ground
You can't see any such thing.

>put horse down
Dropped.

>ride horse
You were pretty sure it was going to be awkward to do this, and it sure is.  Your legs are splayed way out and the hobby horse creaks dangerously under your weight.  It holds solid though, and you creak your way back and forward a few times.  You can say you did it.

>get horse
Taken.

>put horse in box
You put the small hobby horse into the toy box.

>ride horse
The hobby horse takes up most of the box, and doesn't allow a lot of room to ride it.

>get horse
Taken.

* * *

>ride horse
You're holding the hobby horse in both of your hands.  Anyone would be impressed if you found a way to ride it right now.

>n
Seaside Path
You are on the the seaside path.  Backwards from here is The Land of Unrealized Possibilities.  Forward is The Land of Launching and Mooring.

* * *

>n
The Land of Unrealized Possiblities
You are in the Land of Unrealized Possibilities.  Just being here gives you a sense of all that could be accomplished if enough time, effort, and focus were pointed in a specific direction.  There is an sense of both excitement and disappointment here that is almost palpable.  The Hopeful Path leads backward towards The Land of Breakfast and Lunch, a place with a much clearer sense of purpose.

You can see a toy box (closed), a couch (on which is your brother), and a TV here.

>open box
You open the toy box, revealing a wooden block, a small heart shaped locket, and a small hobby horse.

>get horse
Taken.

>look horse
It is a small, wooden hobby horse.  It's very sturdily built, but made to entertain a three-year old.  It has yarn for a mane.

>ride horse
That's not a verb I recognize.

* * *

>get horse
Taken.

>rode horse
That's not a verb I recognize.

>ride horse
You're holding the hobby horse in both of your hands.  Anyone would be impressed if you found a way to ride right now.

>drop horse
Dropped.

* * *

>ride horse
You were pretty sure it was going to be awkward to do this, and it sure is.  Your legs are splayed way out and the hobby horse creaks dangerously under your weight.  It holds solid though, and you creak your way back and forward a few times.  You can say you did it.

>n
You can't go that way.

* * *

>open box
You open the toy box, revealing a wooden block, a small heart shaped locket, and a small hobby horse.

>ride horse
The hobby horse takes up most of the box, and doesn't allow a lot of room to ride it.

>ride locket
You can't ride stuff, silly.

>ride locket
You can't ride stuff, silly.

* * *

>open box
You open the toy box, revealing a wooden block, a small heart shaped locket, and a small hobby horse.

>take hobby horse
That's fixed in place.

* * *

>turn table
hi

>turn north
You must name something more substantial.

* * *

>nearby
That's not a verb I recognize.

>wake up
You are fully alert.

* * *

>plug
What do you want to plug?

>f
You can't see any such thing.

>f
The Land of Breakfast and Lunch
The Land of Breakfast and Lunch is a lot smaller than you were expecting.  It's actually just a small clearing near the road, like a roadside stop, with a painted picnic table containing a simple but nourishing breakfast on one end, and a simple but nourishing lunch on the other end.  A stubby little path leads backwards, and the path continues forward, towards The Land of Unrealized Possibilities.  If you "walk forward" or just "forward" or even just "f" you will be walking towards it.

You can see a painted picnic table (on which are Breakfast and Lunch) here.

* * *

>plug
What do you want to plug?

>plug in
That's not a verb I recognize.

* * *

>pray
You decide to pray in the Tibetan Dzogchen style; you stare at the sky and think of "The Great Perfection".  For one moment, you really feel the great perfection of the moment, of the universe, but then you realize you felt it, and it's over.  Still, you feel calmed.

>sing
I'm not sure what you like to sing in a private moment.  Maybe it's Beyonc, maybe it's a little Sinatra, maybe it's Neutral Milk Hotel, and maybe it's the worms song.  You sing it, whatever it is, and you feel slightly better.

* * *

>score
You have 342,860,965 points.  You're really doing great.

>score
You have 859,102,420 points.  You're really doing great.

>score
You have 619,583,395 points.  You're really doing great.

>score
You have 335,720,140 points.  You're really doing great.

>score
You have 791,190,376 points.  You're really doing great.

>score
You have 419,645,190 points.  You're really doing great.

>score
You have 546,935,422 points.  You're really doing great.

>score
You have 339,849,144 points.  You're really doing great.

>score
You have 725,520,808 points.  You're really doing great.

>score
You have 265,126,147 points.  You're really doing great.

>score
You have 669,160,509 points.  You're really doing great.

>score
You have 921,684,700 points.  You're really doing great.

>score
You have 543,547,326 points.  You're really doing great.

* * *

>sing
I'm not sure what you like to sing in a private moment.  Maybe it's Beyonc, maybe it's a little Sinatra, maybe it's Neutral Milk Hotel, and maybe it's the worms song.  You sing it, whatever it is, and you feel slightly better.

>pray
That's not a verb I recognize.

* * *

>sleep
You don't feel even the tendrils of sleepiness.  You could lie down, but it sounds pretty boring.

* * *

>smell
You smell nothing unexpected.

Then again, you don't have the best sense of smell.  Maybe if you smell specific things it will be easier to discern a smell.

>f
The Land of Breakfast and Lunch
The Land of Breakfast and Lunch is a lot smaller than you were expecting.  It's actually just a small clearing near the road, like a roadside stop, with a painted picnic table containing a simple but nourishing breakfast on one end, and a simple but nourishing lunch on the other end.  A stubby little path leads backwards, and the path continues forward, towards The Land of Unrealized Possibilities.  If you "walk forward" or just "forward" or even just "f" you will be walking towards it.

You can see a painted picnic table (on which are Breakfast and Lunch) here.

>smell lunch
(Lunch)
It smells pretty nice, the individual lunch items each have their own smell.

>f
Hopeful Path
You are on the hopeful path.  Backwards from here is The Land of Breakfast and Lunch.  Forward is The Land of Unrealized Possibilities.

* * *

>f
The Land of Unrealized Possibilities
You are in the Land of Unrealized Possibilities.  Just being here gives you a sense of all that could be accomplished if enough time, effort, and focus were pointed in a specific direction.  There is a sense of both excitement and disappointment here that is almost palpable.  The Hopeful Path leads backward towards The Land of Breakfast and Lunch, a place with a much clearer sense of purpose.  The Seaside Path leads forward, towards The Land of Unlaunched Vessels.

You can see a toy box (closed), a couch (on which is your brother), and a TV here.

>life lid
That's not a verb I recognize.

>lift lid
You open the toy box, revealing a wooden block, a skinny naked plastic doll, a closed jack-in-the-box, a lite-brite, a coloring book, a small heart shaped locket, and a small hobby horse.

>get box
You could probably lift it, but it's a sturdy wooden box and heavier than anything you want to carry around.

>push box
It's a nicely made wooden box, you're just going to scuff it up shoving it around.

>pull box
It's a nicely made wooden box, you're just going to scuff it up shoving it around.

>kick couch
Violence isn't the answer to this one.

>kick brother
Your brother nearly-psychically determines your intention. In a flash, he socks you in the quadricep with precision and speed.  He hits what you realize is an existing bruise from last time and you have to take deep breaths to keep from doubling over in pain.   "What's your problem, you aggro dipwad?" he says, distractedly, eyes still on the TV.

* * *

>sorry
Oh, don't apologize.

>jump
You jump on the spot.

* * *

>test
>--> The following tests are available:
'test me'

* * *

>test askbro
(Testing.)

>[1] f

The Land of Breakfast and Lunch
The Land of Breakfast and Lunch is a lot smaller than you were expecting.  It's actually just a small clearing near the road, like a roadside stop, with a painted picnic table containing a simple but nourishing breakfast on one end, and a simple but nourishing lunch on the other end.  A stubby little path leads backwards, and the path continues forward, towards The Land of Unrealized Possibilities.  If you "walk forward" or just "forward" or even just "f" you will be walking towards it.

You can see a painted picnic table (on which are Breakfast and Lunch) here.

>[2] f

Hopeful Path
You are on the hopeful path.  Backwards from here is The Land of Breakfast and Lunch.  Forward is The Land of Unrealized Possibilities.

>[3] f

The Land of Unrealized Possibilities
You are in the Land of Unrealized Possibilities.  Just being here gives you a sense of all that could be accomplished if enough time, effort, and focus were pointed in a specific direction.  There is a sense of both excitement and disappointment here that is almost palpable.  The Hopeful Path leads backward towards The Land of Breakfast and Lunch, a place with a much clearer sense of purpose.  The Seaside Path leads forward, towards The Land of Unlaunched Vessels.

You can see a toy box (closed), a couch (on which is your brother), and a TV here.

>[4] ask brother about box
"It's the toy box, just look at it yourself."

>[5] ask brother about rocket
"I don't have a quarter, no, but I think there's a penny under the couch."

>[6] ask brother about quarter
"What are you talking about, dogbreath?"

>[7] ask brother about brother
"It's your brother, just look at it yourself."

>test askbro
(Testing.)

>[1] f

Seaside Path
You are on the seaside path.  Backwards from here is The Land of Unrealized Possibilities.  Forward is The Land of Unlaunched Vessels.

>[2] f

The Land of Unlaunched Vessels
You are in The Land of Unlaunched Vessels.  You stand near the edge of the bay, and there is a sailing ship moored here with thick and aged ropes tied to a bollard.  The Hopeful Path leads backward towards The Land of Unrealized Possibilities, a place you're not sure you want to be.  Forward, Sequel Path leads to The Land of Unlaunched Vessels II: The Launchening.

You can see a swarthy hippie seaperson here.

>[3] f

Sequel Path
You are on the sequel path.  Backwards from here is The Land of Unlaunched Vessels.  Forward is The Land of Unlaunched Vessels II: The Launchening.

>[4] ask brother about box
You can't see any such thing.

>[5] ask brother about rocket
You can't see any such thing.

>[6] ask brother about quarter
You can't see any such thing.

>[7] ask brother about brother
You can't see any such thing.

* * *

>test brotalk
(Testing.)

>[1] f

The Land of Breakfast and Lunch
The Land of Breakfast and Lunch is a lot smaller than you were expecting.  It's actually just a small clearing near the road, like a roadside stop, with a painted picnic table containing a simple but nourishing breakfast on one end, and a simple but nourishing lunch on the other end.  A stubby little path leads backwards, and the path continues forward, towards The Land of Unrealized Possibilities.  If you "walk forward" or just "forward" or even just "f" you will be walking towards it.

You can see a painted picnic table (on which are Breakfast and Lunch) here.

>[2] f

Hopeful Path
You are on the hopeful path.  Backwards from here is The Land of Breakfast and Lunch.  Forward is The Land of Unrealized Possibilities.

>[3] f

The Land of Unrealized Possibilities
You are in the Land of Unrealized Possibilities.  Just being here gives you a sense of all that could be accomplished if enough time, effort, and focus were pointed in a specific direction.  There is a sense of both excitement and disappointment here that is almost palpable.  The Hopeful Path leads backward towards The Land of Breakfast and Lunch, a place with a much clearer sense of purpose.  The Seaside Path leads forward, towards The Land of Unlaunched Vessels.

You can see a toy box (closed), a couch (on which is your brother), and a TV here.

>[4] ask brother about box
"It's the toy box, just look at it yourself."

>[5] ask brother about jack-in-the-box
"What are you talking about, dogbreath?"

>[6] tell brother about box
"Yeah, it's the toy box, snotball, what do you want from me?"

>[7] tell brother about jack-in-the-box
"You expect me to believe you saw a real rocket?"

>[8] open box
You open the toy box, revealing a wooden block, a skinny naked plastic doll, a closed jack-in-the-box, a lite-brite, a coloring book, a small heart shaped locket, and a small hobby horse.

>[9] ask brother about jack
"It's the closed jack-in-the-box, just look at it yourself."

>[10] tell brother about jack
"Yeah, it's the closed jack-in-the-box, snotball, what do you want from me?"

>[11] ask brother about rocket
"What are you talking about, dogbreath?"

>[12] tell brother about rocket
"You expect me to believe you saw a real rocket?"

>[13] ask brother about quarter
"What are you talking about, dogbreath?"

>ask brother about couch
"It's the couch, just look at it yourself."

>open box
You open the toy box, revealing a wooden block, a skinny naked plastic doll, a closed jack-in-the-box, a lite-brite, a coloring book, a small heart shaped locket, and a small hobby horse.

>ask brother about boobs
There is no reply.

>ask brother about doll
"It's the skinny naked plastic doll, just look at it yourself."

>ask brother about jack-in-the-box
"It's the closed jack-in-the-box, just look at it yourself."

>ask brother about jack-in-the-box
"It's the closed jack-in-the-box, just look at it yourself."

>tell brother about the jack-in-the-box
Your brother's eyes don't leave the TV, but he does say, "Yeah, it's the closed jack-in-the-box, snotball, what do you want from me?"

I beg your pardon?

>close box
You close the toy box.

>ask brother about jack
There is no reply.

* * *

>ask seaperson about box
You can't see any such thing.

>open box
You open the toy box, revealing a wooden block, a skinny naked plastic doll, a closed jack-in-the-box, a lite-brite, a coloring book, a small heart shaped locket, and a small hobby horse.

>ask brother about jack
"It's the closed jack-in-the-box, just look at it yourself."

>tell brother about jack
Your brother's eyes don't leave the TV, but he does say, "Yeah, it's the closed jack-in-the-box, snotball, what do you want from me?"

>close box
You close the toy box.

* * *

>tell brother about joob
"You expect me to believe you saw a real rocket?"

>ask brother about rocket
"I saw a show about rockets.  It said they have really complicated controls."

>tell brother about rocket
"You expect me to believe you saw a real rocket?"

* * *

>test button
(Testing.)

>[1] f

The Land of Breakfast and Lunch
The Land of Breakfast and Lunch is a lot smaller than you were expecting.  It's actually just a small clearing near the road, like a roadside stop, with a painted picnic table containing a simple but nourishing breakfast on one end, and a simple but nourishing lunch on the other end.  A stubby little path leads backwards, and the path continues forward, towards The Land of Unrealized Possibilities.  If you "walk forward" or just "forward" or even just "f" you will be walking towards it.

You can see a painted picnic table (on which are Breakfast and Lunch) here.

>[2] f

Hopeful Path
You are on the hopeful path.  Backwards from here is The Land of Breakfast and Lunch.  Forward is The Land of Unrealized Possibilities.

>[3] f

The Land of Unrealized Possibilities
You are in the Land of Unrealized Possibilities.  Just being here gives you a sense of all that could be accomplished if enough time, effort, and focus were pointed in a specific direction.  There is an sense of both excitement and disappointment here that is almost palpable.  The Hopeful Path leads backward towards The Land of Breakfast and Lunch, a place with a much clearer sense of purpose.

You can see a toy box (closed), a couch (on which is your brother), a TV, and a kiddie ride here.

>[4] f

Seaside Path
You are on the the seaside path.  Backwards from here is The Land of Unrealized Possibilities.  Forward is The Land of Unlaunched Vessels.

>[5] f

The Land of Unlaunched Vessels
You are in the The Land of Unlaunched Vessels.  You stand near the edge of the bay, and there is a vessel moored here with thick and aged ropes tied to a bollard.  The Hopeful Path leads backward towards The Land of Unrealized Possibilities, a place you're not sure you want to be.  Forward, Sequel Path leads to The Land of Unlaunched Vessels II: The Launchening.

You can see an a swarthy hippie seaperson here.

>[6] f

Sequel Path
You are on the the sequel path.  Backwards from here is The Land of Unlaunched Vessels.  Forward is The Land of Unlaunched Vessels II: The Launchening.

>[7] f

The Land of Unlaunched Vessels II: The Launchening
You are in the The Land of Unlaunched Vessels II: The Launchening.  You stand near the edge of the bay, and there is a vessel moored here with thick and aged ropes tied to a bollard.  Sequel Path leads backwards towards The Land of Unlaunched Vessels

You can see a shiny red button here.

>[8] turn on button
The rocket launches and then takes off.

SPACE1
You are in space 1.

>f
The Land of Unlaunched Vessels
You are in the The Land of Unlaunched Vessels.  You stand near the edge of the bay, and there is a vessel moored here with thick and aged ropes tied to a bollard.  The Hopeful Path leads backward towards The Land of Unrealized Possibilities, a place you're not sure you want to be.

You can see an a swarthy hippie seaperson here.

>f
Sequel Path
You are on the the sequel path.  Backwards from here is The Land of Unlaunched Vessels.  Forward is The Land of Unlaunched Vessels II: The Launchening.

>f
The Land of Unlaunched Vessels II: The Launchening
You are in the The Land of Unlaunched Vessels II: The Launchening.  You stand near the edge of the bay, and there is a vessel moored here with thick and aged ropes tied to a bollard.  Sequel Path leads backwards towards The Land of Unlaunched Vessels

You can see a shiny red button here.

* * *

>look
SPACE4
You are in space 4.

>look
SPACE4
You are in space 4.

>look curtain
You can't see any such thing.

>look stars
You can't see any such thing.

* * *

>look curtain of stars
You can't see any such thing.

>look stars
You can't see any such thing.

* * *

>look stars
There is a curtain of stars here.

* * *

>switch button
You pressed it.

* * *

I beg your pardon?

>look
The Land of Unrealized Possibilities
You are in the Land of Unrealized Possibilities.  Just being here gives you a sense of all that could be accomplished if enough time, effort, and focus were pointed in a specific direction.  There is an sense of both excitement and disappointment here that is almost palpable.  The Hopeful Path leads backward towards The Land of Breakfast and Lunch, a place with a much clearer sense of purpose.

You can see a toy box (in which are a wooden block, a skinny naked plastic doll, a closed jack-in-the-box, a lite-brite, a coloring book, a small heart shaped locket (closed), and a small hobby horse), a couch (on which is your brother), a TV, and a kiddie ride here.

I beg your pardon?

>turn crank
You grasp the little wooden ball and begin to turn the crank as you hold the jack-in-the-box steady.  A dark little tune plinks its way out, echoing forth from the little tin box.  It's not "all around the mulberry bush" or any song you recognize, so you don't quite expect it when its last note ends, and the spring-loaded doll within leaps out with surprising agility.  You jump a tiny bit, in spite of yourself.  The devil doll looks pleased.

>turn crank
You grasp the little wooden ball and begin to turn the crank as you hold the jack-in-the-box steady.  A dark little tune plinks its way out, echoing forth from the little tin box.  It's not "all around the mulberry bush" or any song you recognize, so you don't quite expect it when its last note ends, and the spring-loaded doll within leaps out with surprising agility.  You jump a tiny bit, in spite of yourself.  The devil doll looks pleased.

>look lid
Which do you mean, the closed lid of the jack-in-the-box or the hinged lid?

>look crank
A wire hand crank with a small wooden ball as a handle on the end.  You can turn the crank, but the jack-in-the-box is already out-of-the-box.

>close li
You can't see any such thing.

>close lid
Which do you mean, the closed lid of the jack-in-the-box or the hinged lid?

* * *

>close jack-in-the-box
(the open jack-in-the-box)
You shove the devil doll into the body of the box, and shut the lid with a satisfying snap.

I beg your pardon?

>look coloring book
The title of the coloring book reads "Horse Party!"  Inside are drawings of horses in pastoral settings, but with festive party hats.  They are doing no discernable celebrating.  Seems a little demented, really.  A couple of the pictures are colored neatly, and one is very carefully colored, as if by an adult.

>color book
You don't have anything to color with, but you run your finger over one of the already-colored pages and pretend for a little while.

>look lite-brite
You're looking at a white plastic case with a black plastic pegboard covering one side.   Attached to the back is a black power cord.  If you've seen one before, you know that it's got a little light inside, and usually comes with sheets of black construction paper to affix to the pegboard.  Usually comes with dozens of transparent, colored pegs too.  Push them into the pegboard to make little light-up pictures.  You don't see any of that stuff though.

I beg your pardon?

>look yarn
The mane is made from tight loops of yarn.

>look man
You can't see any such thing.

>look mane
The mane is made from tight loops of yarn.

>twist crank
You grasp the little wooden ball and begin to turn the crank as you hold the jack-in-the-box steady.  A dark little tune plinks its way out, echoing forth from the little tin box.  It's not "all around the mulberry bush" or any song you recognize, so you don't quite expect it when its last note ends, and the spring-loaded doll within leaps out with surprising agility.  You jump a tiny bit, in spite of yourself.  The devil doll looks pleased.

>look eyes
Which do you mean, the human eyes or the black bead eyes?

>look human eyes
On the yellow humvee attached to the kiddie ride are a fiberglass molded set of human-looking eyes.  They're meant to look excited and friendly, but they're straight-up creepy.

I beg your pardon?

* * *

>exit
You exit the hatch opening and climb to the ground.

The Land of Thoroughly-Launched Vessels
You are in The Land of Thoroughly-Launched Vessels.  There is a launchpad here, on which sits a large, 1950's era rocket in galaxy white and candy-apple red. The Spiritual Sequel Path leads backwards towards The Land of Unlaunched Vessels

You can see a launchpad and a Rocket here.

>enter rocket
You pull yourself into the rocket.

The Inside of the Parked Rocket
You are within the smooth walls of the rocket.  It is very plain here, out the porthole window you can see the sky, and out the hatch you can see The Land of Thoroughly-Launched Vessels.

You can see a the cockpit, a big metal unit containing a captain's chair and a control panel here.

>look porthole
The porthole window, at the moment, allows you a good view of the featureless sky above The Land of Thoroughly-Launched Vessels.

>launch
(the the cockpit, a big metal unit containing a captain's chair and a control panel)
It is fixed in place.

>push launch
It's natural to expect blastoff immediately.  Instead, the hatch door whirrs slowly shut, coming to a solid clang.  You have just enough time to realize that you could buckle yourself into the captain's chair and you do.  Just in time, as you feel a tremendous slow and steady thrust of force wrap itself around you as the sky begins to move in the porthole window.  For just one moment you swear you can see The Land of Breakfast and Lunch streak by the window.  Finally, the sky begins to darken, and all sound becomes only a vibration.  The deep, dark void of space is with you.  You absentmindedly unbuckle the webbing securing you to the seat, and you feel free to move about the interior.

The Deep, Dark Void of Space
You are inside the rocket as it cruises very slowly through the deep, dark void of space.  Outside the porthole window is the deep, dark void of space covered over with a curtain of stars.

The the cockpit, a big metal unit containing a captain's chair and a control panel is here.

>ls
That's not a verb I recognize.

>pwd
That's not a verb I recognize.

>look porthole
You can't see any such thing.

I beg your pardon?

* * *

>plug kiddie ride into lite
The lite-brite wasn't made to have anything plugged into it.

>plug lite into kiddie ride
The kiddie ride wasn't made to have anything plugged into it.

>plug lite into outlet
The kiddie ride is plugged into the only outlet.

>unplug kiddie ride
You pull the industrial strength cord out of the liquor store wall.

>plug lite into wall
You plug the lite-brite into the outlet.
The light in the lite-brite springs to life.  It is an odd, orange-tinted bulb.

>plug kiddie ride into wall
The lite-brite is plugged into the only outlet.

>i
You are carrying:
  a small hobby horse
  a small heart shaped locket (closed)
  a coloring book
  a closed jack-in-the-box
  a skinny naked plastic doll
  a wooden block

>look
The Land in Front of the Liquor Store
The Land in Front of the Liquor Store looks mostly abandoned, and you feel a slight sense of disappointment and dread here.  The liquor store is closed, looks like permanently, and there's just a weird kiddie ride here.  There are marks on the sidewalk where some other metal vending machines were, but it looks like they've been carted away.  Only the kiddie ride remains.  It's pretty depressing here, but if you continue to go forward, the Idyllic Path leads to The Land of Puppy Cardiovascular health, which is the H.

You can see a lite-brite (empty) and a kiddie ride here.

>take lite
You unplug the lite-brite first.

You unplug the lite-brite.

Taken.

>look lite
You're looking at a white plastic case with a black plastic pegboard covering one side.   Attached to the back is a black power cord.  If you've seen one before, you know that it's got a little light inside, and usually comes with sheets of black construction paper to affix to the pegboard.  Usually comes with dozens of transparent, colored pegs too.  Push them into the pegboard to make little light-up pictures.

>plug lite into commercial
You plug the lite-brite into the outlet.
The light in the lite-brite springs to life.  It is an odd, orange-tinted bulb.

>take last page
You carefully tear the last page out.  It's actually perforated, so you don't feel so bad.

>put last page in lite
You slide the last page into the lite-brite, activating the glowing ink on the coloring book page.  A luminous horse party begins to glow on the page.

>unplug lite
You unplug the lite-brite.

>plug lite
What do you want to plug the lite-brite into?

>plug lite into cord
Which do you mean, the cord or the industrial strength cord?

>plug lite into wall
The lite-brite is already here.

You plug the lite-brite into the outlet.
The light in the lite-brite springs to life, activating the glowing ink in on the coloring book page.  A luminous horse party begins to glow on the page.  You can only imagine it's more vivid when it's not the broad daylight of The Land in Front of the Liquor Store.

>take last page
Taken.

>put last page into lite
You slide the last page into the lite-brite, activating the glowing ink on the coloring book page.  A luminous horse party begins to glow on the page.

* * *

>test ride
(Testing.)

>[1] f

The Land of Breakfast and Lunch
The Land of Breakfast and Lunch is a lot smaller than you were expecting.  It's actually just a small clearing near the road, like a roadside stop, with a painted picnic table containing a simple but nourishing breakfast on one end, and a simple but nourishing lunch on the other end.  A stubby little path leads backwards, and the path continues forward, towards The Land of Unrealized Possibilities.  If you "walk forward" or just "forward" or even just "f" you will be walking towards it.

You can see a painted picnic table (on which are Breakfast and Lunch) here.

>[2] f

Hopeful Path
You are on the hopeful path.  Backwards from here is The Land of Breakfast and Lunch.  Forward is The Land of Unrealized Possibilities.

>[3] f

The Land of Unrealized Possibilities
You are in the Land of Unrealized Possibilities.  Just being here gives you a sense of all that could be accomplished if enough time, effort, and focus were pointed in a specific direction.  There is an sense of both excitement and disappointment here that is almost palpable.  The Hopeful Path leads backward towards The Land of Breakfast and Lunch, a place with a much clearer sense of purpose.

You can see a toy box (closed), a couch (on which is your brother), a TV, and a kiddie ride here.

>[4] x ride
Off to the side a little ways is a mechanical kiddie ride.  It's a big (to a child) yellow humvee with cartoon human eyes where the headlights should be.  It's anchored to a diamond plate platform and looks to have stopped mid-tilt.

Mounted on a post next to it is a coin box showing the coin denomination necessary to make it run: 25, or one U.S. quarter dollar piece.

There were once two of these rides outside every grocery store in America.  Whether they died out because kids collectively realized they weren't fun, or just liability, you're surprised to see this one here.

The kiddie ride is currently switched off.

>[5] press coin release button
you did @TODO
>[6] look under couch
There's nothing under there except a small, grimy penny.

>[7] get penny
Taken.

>[8] put penny in slot
The penny slides down the chute, briefly contacts some mechanism inside, and clanks out the coin return tray.

>b
Hopeful Path
You are on the hopeful path.  Backwards from here is The Land of Breakfast and Lunch.  Forward is The Land of Unrealized Possibilities.

* * *

>look under couch
You can't see any such thing.

>f
Hopeful Path
You are on the hopeful path.  Backwards from here is The Land of Breakfast and Lunch.  Forward is The Land of Unrealized Possibilities.

* * *

I beg your pardon?

>look under couch
You can't see any such thing.

>f
The Land of Unrealized Possibilities
You are in the Land of Unrealized Possibilities.  Just being here gives you a sense of all that could be accomplished if enough time, effort, and focus were pointed in a specific direction.  There is an sense of both excitement and disappointment here that is almost palpable.  The Hopeful Path leads backward towards The Land of Breakfast and Lunch, a place with a much clearer sense of purpose.

You can see a toy box (closed), a couch (on which is your brother), a TV, and a Kiddie Ride here.

>look under couch
There's nothing under there except a small, grimy penny.

* * *

>get penny
Taken.

>put penny in slot
you dddiiiid

I beg your pardon?

>x
(grimy penny under the couch)
It's a single penny, so grimy you can't read the date.  It looks older than 1982, which means it's made of solid copper, but coated in rust and grime.

>look
The Land of Unrealized Possibilities
You are in the Land of Unrealized Possibilities.  Just being here gives you a sense of all that could be accomplished if enough time, effort, and focus were pointed in a specific direction.  There is an sense of both excitement and disappointment here that is almost palpable.  The Hopeful Path leads backward towards The Land of Breakfast and Lunch, a place with a much clearer sense of purpose.

You can see a toy box (closed), a couch (on which is your brother), a TV, and a Kiddie Ride here.

* * *

>get penny
Taken.

>put penny in slot
The penny slides down the chute, briefly contacts some mechanism inside, and clanks out the coin return tray.

>put penny in slot
The penny slides down the chute, briefly contacts some mechanism inside, and clanks out the coin return tray.

* * *

>get penny
Taken.

>put penny in tray
Normally you'd put the coin in the coin slot, but you lay the penny in the coin return anyway, perhaps to frustrate someone who comes along and thinks it might be a quarter, but then realizes it isn't.

>get penny
Taken.

* * *

>put penny in slot
The penny slides down the chute, briefly contacts some mechanism inside, and clanks out the coin return tray.

>look tray
The coin return tray is a shallow metal tray designed to let a coin of any size strike the bottom, convulse in a spasm of physics and metallurgy, and safely come to a rest, waiting for a person to collect it.

In the coin return tray is a small, grimy penny from under the couch.

>put penny in slot
The penny slides down the chute, briefly contacts some mechanism inside, and clanks out the coin return tray.

* * *

>look
The Land of Unrealized Possibilities
You are in the Land of Unrealized Possibilities.  Just being here gives you a sense of all that could be accomplished if enough time, effort, and focus were pointed in a specific direction.  There is an sense of both excitement and disappointment here that is almost palpable.  The Hopeful Path leads backward towards The Land of Breakfast and Lunch, a place with a much clearer sense of purpose.

You can see a toy box (closed), a couch (on which is your brother), a TV, and a kiddie ride here.

I beg your pardon?

>open box
(the toy box)
You open the toy box, revealing a wooden block, a small heart shaped locket, and a small hobby horse.

>get block
Taken.

>put block in tray
You put the wooden block into the coin return tray.

>get block
Taken.

* * *

>look
The Land of Unrealized Possibilities
You are in the Land of Unrealized Possibilities.  Just being here gives you a sense of all that could be accomplished if enough time, effort, and focus were pointed in a specific direction.  There is an sense of both excitement and disappointment here that is almost palpable.  The Hopeful Path leads backward towards The Land of Breakfast and Lunch, a place with a much clearer sense of purpose.

You can see a toy box (closed), a couch (on which is your brother), a TV, and a kiddie ride here.

>look coin slot
It's a chrome slot to put a coin in.

>get penny
Taken.

>.
That's not a verb I recognize.

>put penny in slot
The penny slides down the chute, briefly contacts some mechanism inside, and clanks out the coin return tray.

>look tray
The coin return tray is a shallow metal tray designed to let a coin of any size strike the bottom, convulse in a spasm of physics and metallurgy, and safely come to a rest, waiting for a person to collect it.

In the coin return tray is grimy penny from under the couch.

* * *

>look
The Land of Unrealized Possibilities
You are in the Land of Unrealized Possibilities.  Just being here gives you a sense of all that could be accomplished if enough time, effort, and focus were pointed in a specific direction.  There is an sense of both excitement and disappointment here that is almost palpable.  The Hopeful Path leads backward towards The Land of Breakfast and Lunch, a place with a much clearer sense of purpose.

You can see a toy box (closed), a couch (on which is your brother), a TV, and a kiddie ride here.

>take coin release
That seems to be a part of the coin box.

>take coin box
That seems to be a part of the Kiddie Ride.

>take ride
That's fixed in place.

* * *

>look car
Off to the side a little ways is a mechanical kiddie ride.  It's a big (to a child) yellow humvee with cartoon human eyes where the headlights should be.  It's anchored to a diamond plate platform and looks to have stopped mid-tilt.

Mounted on a post next to it is a coin box showing the coin denomination necessary to make it run: 25, or one U.S. quarter dollar piece.

There were once two of these rides outside every grocery store in America.  Whether they died out because kids collectively realized they weren't fun, or just liability, you're surprised to see this one here.

The Kiddie Ride is currently switched off.

>look ride
Off to the side a little ways is a mechanical kiddie ride.  It's a big (to a child) yellow humvee with cartoon human eyes where the headlights should be.  It's anchored to a diamond plate platform and looks to have stopped mid-tilt.

Mounted on a post next to it is a coin box showing the coin denomination necessary to make it run: 25, or one U.S. quarter dollar piece.

There were once two of these rides outside every grocery store in America.  Whether they died out because kids collectively realized they weren't fun, or just liability, you're surprised to see this one here.

The Kiddie Ride is currently switched off.

>look coin box
The coin box is a sturdy steel box with a coin slot in one end (25) and a coin return on the other.  Next to the coin box is a small, cylindrical coin-release button.

>look release
The coin release button is a small chrome cylinder that can be depressed all the way down into the coin box.

>press release
It is fixed in place.

* * *

>look penny
It's a single penny, so grimy you can't read the date.  It looks older than 1982, which means it's made of solid copper, but coated in rust and grime.

>look slot
It's a chrome slot to put a coin in.

>look tray
The coin return tray is a shallow metal tray designed to let a coin of any size strike the bottom, convulse in a spasm of physics and metallurgy, and safely come to a rest, waiting for a person to collect it.

In the coin return tray is a small, grimy penny from under the couch.

* * *

>look slot
It's a chrome slot to put a coin in.

>get slot
That's fixed in place.

* * *

>look tray
The coin return tray is a shallow metal tray designed to let a coin of any size strike the bottom, convulse in a spasm of physics and metallurgy, and safely come to a rest, waiting for a person to collect it.

In the coin return tray is an a small, grimy penny from under the couch.

* * *

>look under couch
There's nothing under there except a small, grimy penny.

* * *

>get penny
Taken.

>put penny in coin slot
It won't fit.  It's not a coin.

* * *

>put penny in slot
The penny slides down the chute, briefly contacts some mechanism inside, and clanks out the coin return tray.

>put penny in tray
Normally you'd put the coin in the coin slot, but you lay the penny in the coin return anyway, perhaps to frustrate someone who comes along and thinks it might be a quarter, but then realizes it isn't.

>get penny
You already have that.

* * *

>put penny in tray
Normally you'd put the coin in the coin slot, but you lay the penny in the coin return anyway, perhaps to frustrate someone who comes along and thinks it might be a quarter, but then realizes it isn't.

* * *

>ride ride
You can't ride stuff like that, silly.

>look eyes
They're meant to look excited and friendly, but they're straight-up creepy.

* * *

>turn ride on
You switch the Kiddie Ride on.

>x ride
It's on

* * *

>test rider
>--> The following tests are available:
'test ride'
'test button'

>f
The Land of Breakfast and Lunch
The Land of Breakfast and Lunch is a lot smaller than you were expecting.  It's actually just a small clearing near the road, like a roadside stop, with a painted picnic table containing a simple but nourishing breakfast on one end, and a simple but nourishing lunch on the other end.  A stubby little path leads backwards, and the path continues forward, towards The Land of Unrealized Possibilities.  If you "walk forward" or just "forward" or even just "f" you will be walking towards it.

You can see a painted picnic table (on which are Breakfast and Lunch) here.

* * *

>f
Hopeful Path
You are on the hopeful path.  Backwards from here is The Land of Breakfast and Lunch.  Forward is The Land of Unrealized Possibilities.

>f
The Land of Unrealized Possibilities
You are in the Land of Unrealized Possibilities.  Just being here gives you a sense of all that could be accomplished if enough time, effort, and focus were pointed in a specific direction.  There is an sense of both excitement and disappointment here that is almost palpable.  The Hopeful Path leads backward towards The Land of Breakfast and Lunch, a place with a much clearer sense of purpose.

You can see a toy box (closed), a couch (on which is your brother), a TV, a Kiddie Ride, and a coin slot here.

>look under couch
There's nothing under there except a small, grimy penny.

* * *

>f
The Land of Unlaunched Vessels
You are in the The Land of Unlaunched Vessels.  You stand near the edge of the bay, and there is a vessel moored here with thick and aged ropes tied to a bollard.  The Hopeful Path leads backward towards The Land of Unrealized Possibilities, a place you're not sure you want to be.  Forward, Sequel Path leads to The Land of Unlaunched Vessels II: The Launchening.

You can see an a swarthy hippie seaperson here.

>s
Seaside Path
You are on the the seaside path.  Backwards from here is The Land of Unrealized Possibilities.  Forward is The Land of Unlaunched Vessels.

>s
The Land of Unrealized Possibilities
You are in the Land of Unrealized Possibilities.  Just being here gives you a sense of all that could be accomplished if enough time, effort, and focus were pointed in a specific direction.  There is an sense of both excitement and disappointment here that is almost palpable.  The Hopeful Path leads backward towards The Land of Breakfast and Lunch, a place with a much clearer sense of purpose.

You can see a toy box (closed), a couch (on which is your brother), a TV, a Kiddie Ride, and a coin slot here.

* * *

I beg your pardon?

>press red button
The rocket launches and then takes off.

The Deep, Dark Void of Space
You are inside the rocket as it cruises very slowly through the deep, dark void of space.  Outside the porthole window you see the deep, dark void of space covered over with a curtain of stars.

The the cockpit, a big metal unit containing a captain's chair and a control panel is here.

>press red button
The rocket launches and then takes off.

The Deep, Dark Void of Space
You are inside the rocket as it cruises very slowly through the deep, dark void of space.  Outside the porthole window you see the deep, dark void of space covered over with a curtain of stars.

The the cockpit, a big metal unit containing a captain's chair and a control panel is here.

* * *

I beg your pardon?

>look control panel
The control panel is an extremely austere, some might even say naive set of controls.  There is a large, shiny, red button labeled "Launch", a smaller black button that labeled "Return", and then off to your right, a medium-sized bright blue button labeled "Forward".  Finally, along the top is a small LED readout display that says The Land of Unlaunched Vessels II: The Launchening.

That's it.  Surely you should be able to operate a spacecraft with only those controls?  (You look on the front for a button marked "Fire Laser" or "Warp 7" but those buttons are not on the control panel or anywhere else inside the ship.)

>look readout
The LED readout display is a small, crude screen made of LED lights that looks like it could display about 50 letters in a pinch.  It currently says: The Land of Unlaunched Vessels II: The Launchening.

>press button
Which do you mean, the shiny red launch button, the smaller black return button, or the medium-sized blue forward button?

>press red button
The rocket launches and then takes off.

The Deep, Dark Void of Space
You are inside the rocket as it cruises very slowly through the deep, dark void of space.  Outside the porthole window you see the deep, dark void of space covered over with a curtain of stars.

The the cockpit, a big metal unit containing a captain's chair and a control panel is here.

>look readout
The LED readout display is a small, crude screen made of LED lights that looks like it could display about 50 letters in a pinch.  It currently says: The Deep, Dark Void of Space.

I beg your pardon?

>press launch button
The rocket launches and then takes off.

The Deep, Dark Void of Space
You are inside the rocket as it cruises very slowly through the deep, dark void of space.  Outside the porthole window you see the deep, dark void of space covered over with a curtain of stars.

The the cockpit, a big metal unit containing a captain's chair and a control panel is here.

>press forward button
Whoosh.

Porcine Solar System
You are inside the rocket as it cruises very slowly through the deep, dark void of space.  Outside the porthole window you see the deep, dark void of space covered over with a curtain of stars.

The the cockpit, a big metal unit containing a captain's chair and a control panel is here.

You notice something unusual outside the porthole window.

>look readout
The LED readout display is a small, crude screen made of LED lights that looks like it could display about 50 letters in a pinch.  It currently says: Porcine Solar System.

I beg your pardon?

>look
Porcine Solar System
You are inside the rocket as it cruises very slowly through the deep, dark void of space.  Outside the porthole window you see the deep, dark void of space covered over with a curtain of stars.

The the cockpit, a big metal unit containing a captain's chair and a control panel is here.

You notice something unusual outside the porthole window.

I beg your pardon?

* * *

>f
You can't go that way.

I beg your pardon?

>look out window
I only understood you as far as wanting to look outside.

>look out porthole
I only understood you as far as wanting to look outside.

* * *

>close hatch
You close the hatch.

>enter rocket
The hatch is closed.

* * *

>enter chair
That's not something you can enter.

>enter cockpit
That's not something you can enter.

>sit on chair
That's not something you can sit down on.

>look chir
You can't see any such thing.

>look chair
You look at the captain's chair very closely indeed, and to be completely honest, it looks about how you'd expect.  You think for a moment that there might be something slightly special about it but then, upon looking just a little closer, you see that there isn't.

* * *

>look
The Inside of the Parked Rocket
You are within the smooth walls of the rocket.  It is very plain here, out the porthole window you can see The Land of Unlaunched Vessels II: The Launchening.

You can see a cockpit here.

>look cockpit
The cockpit, containing the captain's chair and the control panel is firmly mounted to the inner wall of the rocket across from the porthole.  The captain's chair is angled so that you can sit in it when the rocket is vertical or horizontal.

>look chair
The captain's chair is rightfully named.  It looks fit for a captain.  It's leather-clad, and the same galaxy white and candy-apple red as the exterior of the ship.

>sit in chair
That's not something you can sit down on.

>look button
Which do you mean, the shiny red launch button, the smaller black return button, or the medium-sized blue forward button?

>look launch button
You look at the shiny red launch button very closely indeed, and to be completely honest, it looks about how you'd expect.  You think for a moment that there might be something slightly special about it but then, upon looking just a little closer, you see that there isn't.

The shiny red launch button is currently switched off.

>press launch button
The rocket launches and then takes off.

SPACE7
You are inside the rocket. You are in space 7.

>look
SPACE7
You are inside the rocket. You are in space 7.

>look button
Which do you mean, the shiny red launch button, the smaller black return button, or the medium-sized blue forward button?

>look control panel
The control panel is an extremely austere, some might even say naive set of controls.  There is a large, shiny, red button labeled "Launch", a smaller black button that labeled "Return", and then off to your right, a medium-sized bright blue button labeled "Forward".  That's it.  Surely you should be able to operate a spacecraft with only those controls?  You look on the front for a button marked "Laser" or "Warp" but those buttons are not on the control panel or anywhere else inside the ship.

* * *

>look hatch
The hatch is wide open and the hatch door is out of reach.

>close hatch
The hatch door is out of reach from where you're standing.  It doesn't seem possible to close it from inside the rocket.  There's probably some control inside the rocket that closes it.

I beg your pardon?

>leave rocket
You exit the hatch opening and climb to the ground.

The Land of Unlaunched Vessels II: The Launchening
You are in The Land of Unlaunched Vessels II: The Launchening.  There is a launchpad here, on which sits a large, 1950's era rocket in galaxy white and candy-apple red. Sequel Path leads backwards towards The Land of Unlaunched Vessels

You can see a launchpad and a Rocket here.

>climb ladder
You pull yourself into the rocket.

The Inside of the Parked Rocket
You are within the smooth walls of the rocket.  It is very plain here, out the porthole window you can see the sky, and out the hatch you can see The Land of Unlaunched Vessels II: The Launchening.

You can see a the cockpit, a big metal unit containing a captain's chair and a control panel here.

>look walls
The walls are smooth and cool and curved.  The rocket is made extremely well, as there are no seams anywhere you can see.

>look rocket
The walls are smooth and cool and curved.  The rocket is made extremely well, as there are no seams anywhere you can see.

>leave rocket
You exit the hatch opening and climb to the ground.

The Land of Unlaunched Vessels II: The Launchening
You are in The Land of Unlaunched Vessels II: The Launchening.  There is a launchpad here, on which sits a large, 1950's era rocket in galaxy white and candy-apple red. Sequel Path leads backwards towards The Land of Unlaunched Vessels

You can see a launchpad and a Rocket here.

>exit rocket
You can't see any such thing.

>get out
But you aren't in anything at the moment.

>rocket
That's not a verb I recognize.

>enter rocket
You pull yourself into the rocket.

The Inside of the Parked Rocket
You are within the smooth walls of the rocket.  It is very plain here, out the porthole window you can see the sky, and out the hatch you can see The Land of Unlaunched Vessels II: The Launchening.

You can see a the cockpit, a big metal unit containing a captain's chair and a control panel here.

>press red button
You're too hungry to go to space.

* * *

>press button
The rocket launches and then takes off.

SPACE2
You are in space 2.

>look
SPACE2
You are in space 2.

>look stars
There is a curtain of stars here.

* * *

>push button
The rocket launches and then takes off.

SPACE4
You are in space 4.

>push button
You can't see any such thing.

* * *

>push red button
The rocket launches and then takes off.

SPACE6
You are inside the rocket as it cruises very slowly through the deep, dark, void of space.  Outside the porthole window you see the deep, dark void of space covered over with a curtain of stars.  Here, in the rocket, is the captain's chair, the smooth walls of the spaceship You are in space 6.

>push red button
The rocket launches and then takes off.

SPACE1
You are inside the rocket as it cruises very slowly through the deep, dark, void of space.  Outside the porthole window you see the deep, dark void of space covered over with a curtain of stars.  Here, in the rocket, is the captain's chair, the smooth walls of the spaceship You are in space 1.

>push red button
The rocket launches and then takes off.

SPACE1
You are inside the rocket as it cruises very slowly through the deep, dark, void of space.  Outside the porthole window you see the deep, dark void of space covered over with a curtain of stars.  Here, in the rocket, is the captain's chair, the smooth walls of the spaceship You are in space 1.

>push red button
The rocket launches and then takes off.

SPACE6
You are inside the rocket as it cruises very slowly through the deep, dark, void of space.  Outside the porthole window you see the deep, dark void of space covered over with a curtain of stars.  Here, in the rocket, is the captain's chair, the smooth walls of the spaceship You are in space 6.

>push red button
The rocket launches and then takes off.

SPACE5
You are inside the rocket as it cruises very slowly through the deep, dark, void of space.  Outside the porthole window you see the deep, dark void of space covered over with a curtain of stars.  Here, in the rocket, is the captain's chair, the smooth walls of the spaceship You are in space 5.

>push red button
The rocket launches and then takes off.

SPACE5
You are inside the rocket as it cruises very slowly through the deep, dark, void of space.  Outside the porthole window you see the deep, dark void of space covered over with a curtain of stars.  Here, in the rocket, is the captain's chair, the smooth walls of the spaceship You are in space 5.

>push red button
The rocket launches and then takes off.

SPACE2
You are inside the rocket as it cruises very slowly through the deep, dark, void of space.  Outside the porthole window you see the deep, dark void of space covered over with a curtain of stars.  Here, in the rocket, is the captain's chair, the smooth walls of the spaceship You are in space 2.

>push red button
The rocket launches and then takes off.

SPACE7
You are inside the rocket as it cruises very slowly through the deep, dark, void of space.  Outside the porthole window you see the deep, dark void of space covered over with a curtain of stars.  Here, in the rocket, is the captain's chair, the smooth walls of the spaceship You are in space 7.

>push red button
The rocket launches and then takes off.

SPACE2
You are inside the rocket as it cruises very slowly through the deep, dark, void of space.  Outside the porthole window you see the deep, dark void of space covered over with a curtain of stars.  Here, in the rocket, is the captain's chair, the smooth walls of the spaceship You are in space 2.

>push red button
The rocket launches and then takes off.

SPACE4
You are inside the rocket as it cruises very slowly through the deep, dark, void of space.  Outside the porthole window you see the deep, dark void of space covered over with a curtain of stars.  Here, in the rocket, is the captain's chair, the smooth walls of the spaceship You are in space 4.

>push red button
The rocket launches and then takes off.

SPACE7
You are inside the rocket as it cruises very slowly through the deep, dark, void of space.  Outside the porthole window you see the deep, dark void of space covered over with a curtain of stars.  Here, in the rocket, is the captain's chair, the smooth walls of the spaceship You are in space 7.

>push red button
The rocket launches and then takes off.

SPACE1
You are inside the rocket as it cruises very slowly through the deep, dark, void of space.  Outside the porthole window you see the deep, dark void of space covered over with a curtain of stars.  Here, in the rocket, is the captain's chair, the smooth walls of the spaceship You are in space 1.

>push red button
The rocket launches and then takes off.

SPACE4
You are inside the rocket as it cruises very slowly through the deep, dark, void of space.  Outside the porthole window you see the deep, dark void of space covered over with a curtain of stars.  Here, in the rocket, is the captain's chair, the smooth walls of the spaceship You are in space 4.

>push red button
The rocket launches and then takes off.

SPACE6
You are inside the rocket as it cruises very slowly through the deep, dark, void of space.  Outside the porthole window you see the deep, dark void of space covered over with a curtain of stars.  Here, in the rocket, is the captain's chair, the smooth walls of the spaceship You are in space 6.

>push red button
The rocket launches and then takes off.

SPACE7
You are inside the rocket as it cruises very slowly through the deep, dark, void of space.  Outside the porthole window you see the deep, dark void of space covered over with a curtain of stars.  Here, in the rocket, is the captain's chair, the smooth walls of the spaceship You are in space 7.

>push red button
The rocket launches and then takes off.

SPACE7
You are inside the rocket as it cruises very slowly through the deep, dark, void of space.  Outside the porthole window you see the deep, dark void of space covered over with a curtain of stars.  Here, in the rocket, is the captain's chair, the smooth walls of the spaceship You are in space 7.

* * *

>retract launchpad
the launchpad is not retractable.

>retract fins
the fins is not retractable.

* * *

>test rocket
(Testing.)

>[1] f
You can't go that way.

>[2] f
You can't go that way.

>[3] f
You can't go that way.

>[4] f
You can't go that way.

>[5] f
You can't go that way.

>[6] f
You can't go that way.

>[7] f
You can't go that way.

>[8] x launchpad
You can't see any such thing.

>[9] x rocket
You can't see any such thing.

>[10] x porthole
You can't see any such thing.

>[11] x bubble
You can't see any such thing.

>[12] x fins
You can't see any such thing.

>[13] x hatch
You can't see any such thing.

>[14] x ladder
You can't see any such thing.

>[15] x cone
You can't see any such thing.

>[16] x spheres
You can't see any such thing.

>[17] retract ladder
You can't see any such thing.

>[18] climb ladder
You can't see any such thing.

>[19] enter rocket
You can't see any such thing.

>[20] open hatch
You can't see any such thing.

>[21] enter rocket
You can't see any such thing.

>look
The Inside of the Parked Rocket
You are within the smooth walls of the rocket.  It is very plain here, out the portal you can see  The Land of Unlaunched Vessels II: The Launchening.

You can see a The cockpit, containing the captain's chair and the control panel is across from the porthole. here.

* * *

>use handle
You close the hatch.

>use handle
You open the hatch.

* * *

>use handle
You close the hatch.

>use hatch
You can't see any such thing.

>look hatch
The hatch is a small door in the rocket.  It has a hinge on the side, and a handle that looks like the locking handle on the door of a 1950's refrigerator.

>open hatch
That's already open.

>close hatch
You close the hatch.

>use hatch
You can't see any such thing.

* * *

>look
Chrysocolla Cluster
You are inside the rocket as it cruises very slowly through the deep, dark void of space.  Outside the porthole window is the deep, dark void of space covered over with a curtain of stars.

You notice something unusual outside the porthole window.

You can see a the cockpit, a big metal unit containing a captain's chair and a control panel here.

I beg your pardon?

>press black
Whoosh. At the end of the rocket's soft whoosh, its mighty engines begin to engage, slowing its fall as it pillows down to the landing pad in The Land of Once Launched Vessels.

The Inside of the Parked Rocket
You are within the smooth walls of the rocket.  It is very plain here, out the porthole window you can see the sky, and out the hatch you can see The Land of Once Launched Vessels.

>press forward
There is only the soft click of the button's mechanism.  It might only work when the rocket has been launched.

>look porthole
The porthole window, at the moment, allows you a good view of the featureless sky above The Land of Once Launched Vessels.

>press launch
It's natural to expect blastoff immediately.  Instead, the hatch door whirrs slowly shut, coming to a solid clang.  You have just enough time to realize that you could buckle yourself into the captain's chair and you do.  Just in time, as you feel a tremendous slow and steady thrust of force wrap itself around you as the sky begins to move in the porthole window.  For just one moment you swear you can see The Land of Breakfast and Lunch streak by the window.  Finally, the sky begins to darken, and all sound becomes only a vibration.  The deep, dark void of space is with you.  You absentmindedly unbuckle the webbing securing you to the seat, and you feel free to move about the interior.

The Deep, Dark Void of Space
You are inside the rocket as it cruises very slowly through the deep, dark void of space.  Outside the porthole window is the deep, dark void of space covered over with a curtain of stars.

>look porthole
If you push your head out a little past the walls of the ship into the bubble of the porthole window, you can see quite a vista.   It's hard to make out any specific detail here, just a ceaseless curtain of stars that extends forever.  All of it looks very far away.

>look window
If you push your head out a little past the walls of the ship into the bubble of the porthole window, you can see quite a vista.   It's hard to make out any specific detail here, just a ceaseless curtain of stars that extends forever.  All of it looks very far away.

I beg your pardon?

>look stars
The curtain of stars is laid majestically over the black cloud of forever.  There are an infinite number of constellations you can make just by drawing pictures between different bright points, but out here there's too much to connect, and it almost looks like a continuous fabric.  Clusters, galaxies, pulsars, gas giants, form a vast curtain covering the outside of the porthole window, that almost appears to undulate before your eyes.

>look cluster
Clusters of galaxies, not nuts.

>look galaxy
The galaxies just look like cool spiral shapes, but really every single one of them is a vast collection of stars spinning around some incredibly attractive center.

>look center
Spoiler: The centers of the galaxies are black holes, probably.

I beg your pardon?

>look pulsar
The pulsars just look like blinking stars, but really they're rotating like little lighthouses in the sky.

>look giant
They are very big stars.

>smell giant
The ship itself is very clean, sanitary, and hermetically sealed.  No smells from space can reach you.

>smell ship
The ship itself is very clean, sanitary, and hermetically sealed.  No smells from space can reach you.

>look walls
The walls are smooth and cool and curved.  The rocket is made extremely well, as there are no seams anywhere you can see.

>push forward
Whoosh.  You thought maybe the engine engaged again, but something else already did.  It bent space softly around you, and, maybe the rocket moved a little.  Like with a soft whoosh.  It happened in less than a second.  Now, you think you're somewhere else.

Kamiro Quadrant
You are inside the rocket as it cruises very slowly through the deep, dark void of space.  Outside the porthole window is the deep, dark void of space covered over with a curtain of stars.

You notice something unusual outside the porthole window.

>push forward
Whoosh.  You thought maybe the engine engaged again, but something else already did.  It bent space softly around you, and, maybe the rocket moved a little.  Like with a soft whoosh.  It happened in less than a second.  Now, you think you're somewhere else.

Chrysocolla Cluster
You are inside the rocket as it cruises very slowly through the deep, dark void of space.  Outside the porthole window is the deep, dark void of space covered over with a curtain of stars.

You notice something unusual outside the porthole window.

>look
Chrysocolla Cluster
You are inside the rocket as it cruises very slowly through the deep, dark void of space.  Outside the porthole window is the deep, dark void of space covered over with a curtain of stars.

You notice something unusual outside the porthole window.

You can see a cockpit, a big metal unit containing a captain's chair and a control panel here.

>wave
You wave your little heart out, but that doesn't get the simian businessperson's attention.

>wave at businessperson
You wave your little heart out, but that doesn't get the simian businessperson's attention.

>look businessperson
The simian businessperson looks like they could be a human or monkey, but with elaborate stage makeup.  Their fur is a pale pink, and they have an oddly shaped skull.  You think "businessperson", because of the exquisitely tailored suit of clothes.  The simian is just floating softly in space, as if killing time while waiting for a bus, fidgeting with eight-fingered, pink hands.  Paws.  You can't quite see what it is, but the simian is spinning some very small object in its fingers.

* * *

>look center
Spoiler: The centers of the galaxies are black holes, probably.

>look pulsar
The pulsars just look like blinking stars, but really they're rotating like little lighthouses in the sky.

* * *

>look giant
They are very big stars.

>smell giant
no

* * *

I beg your pardon?

>press blue
Whoosh.  You thought maybe the engine engage again, but something else already did.  It bent space softly around you, and, maybe the rocket moved a little.  Like with a soft whoosh.  It happened in less than a second.  You think you're somewhere else.

Porcine Cluster
You are inside the rocket as it cruises very slowly through the deep, dark void of space.  Outside the porthole window is the deep, dark void of space covered over with a curtain of stars.

The the cockpit, a big metal unit containing a captain's chair and a control panel is here.

You notice something unusual outside the porthole window.

>press blue
Whoosh.  You thought maybe the engine engage again, but something else already did.  It bent space softly around you, and, maybe the rocket moved a little.  Like with a soft whoosh.  It happened in less than a second.  You think you're somewhere else.

Kamiro Quadrant
You are inside the rocket as it cruises very slowly through the deep, dark void of space.  Outside the porthole window is the deep, dark void of space covered over with a curtain of stars.

The the cockpit, a big metal unit containing a captain's chair and a control panel is here.

You notice something unusual outside the porthole window.

>i
You examine what you'd normally use to carry things, all the way from fingertip to elbow.  As you suspected, nothing is contained there.  You briefly check for pockets or some kind of fanny pack.  There isn't anything like that.  You are forced to conclude that you have no possessions.

I beg your pardon?

>i
You examine what you'd normally use to carry things, all the way from fingertip to elbow.  As you suspected, nothing is contained there.  You briefly check for pockets or some kind of fanny pack.  There isn't anything like that.  You are forced to conclude that you have no possessions.

>look cockpit
The cockpit, containing the captain's chair and the control panel is firmly mounted to the inner wall of the rocket across from the porthole.  The captain's chair is angled so that you can sit in it when the rocket is vertical or horizontal.

* * *

>get quarter
You can't see any such thing.

>look quarter
You can't see any such thing.

>test space
(Testing.)

>[1] f
You can't go that way.

>[2] eat breakfast
You can't see any such thing.

>[3] eat lunch
You can't see any such thing.

>[4] f
You can't go that way.

>[5] f
You can't go that way.

>[6] f
You can't go that way.

>[7] f
You can't go that way.

>[8] f
You can't go that way.

>[9] f
You can't go that way.

>[10] open hatch
The inner hatch is closed and magnetically locked.  You expect landing the rocket would unlock the hatch.

>[11] climb ladder
You can't see any such thing.

>[12] press red button
It's natural to expect blastoff immediately.  Instead, the hatch door whirrs slowly shut, coming to a solid clang.  You have just enough time to realize that you could buckle yourself into the captain's chair and you do.  Just in time, as you feel a tremendous slow and steady thrust of force wrap itself around you as the sky begins to move in the porthole window.  For just one moment you swear you can see The Land of Breakfast and Lunch streak by the window.  Finally, the sky begins to darken, and all sound becomes only a vibration.  The deep, dark void of space is with you.  You absentmindedly unbuckle the webbing securing you to the seat, and you feel free to move about the interior.

The Deep, Dark Void of Space
You are inside the rocket as it cruises very slowly through the deep, dark void of space.  Outside the porthole window is the deep, dark void of space covered over with a curtain of stars.

The the cockpit, a big metal unit containing a captain's chair and a control panel is here.

>[13] press blue button
Whoosh.  You thought maybe the engine engage again, but something else already did.  It bent space softly around you, and, maybe the rocket moved a little.  Like with a soft whoosh.  It happened in less than a second.  You think you're somewhere else.

Porcine Cluster
You are inside the rocket as it cruises very slowly through the deep, dark void of space.  Outside the porthole window is the deep, dark void of space covered over with a curtain of stars.

The the cockpit, a big metal unit containing a captain's chair and a control panel is here.

You notice something unusual outside the porthole window.

>press blue
Whoosh.  You thought maybe the engine engage again, but something else already did.  It bent space softly around you, and, maybe the rocket moved a little.  Like with a soft whoosh.  It happened in less than a second.  You think you're somewhere else.

Kamiro Quadrant
You are inside the rocket as it cruises very slowly through the deep, dark void of space.  Outside the porthole window is the deep, dark void of space covered over with a curtain of stars.

The the cockpit, a big metal unit containing a captain's chair and a control panel is here.

You notice something unusual outside the porthole window.

>press blue
Whoosh.  You thought maybe the engine engage again, but something else already did.  It bent space softly around you, and, maybe the rocket moved a little.  Like with a soft whoosh.  It happened in less than a second.  You think you're somewhere else.

Elbow Nebula
You are inside the rocket as it cruises very slowly through the deep, dark void of space.  Outside the porthole window is the deep, dark void of space covered over with a curtain of stars.

The the cockpit, a big metal unit containing a captain's chair and a control panel is here.

You notice something unusual outside the porthole window.

>press blue
Whoosh.  You thought maybe the engine engage again, but something else already did.  It bent space softly around you, and, maybe the rocket moved a little.  Like with a soft whoosh.  It happened in less than a second.  You think you're somewhere else.

Elbow Nebula
You are inside the rocket as it cruises very slowly through the deep, dark void of space.  Outside the porthole window is the deep, dark void of space covered over with a curtain of stars.

The the cockpit, a big metal unit containing a captain's chair and a control panel is here.

You notice something unusual outside the porthole window.

>press blue
Whoosh.  You thought maybe the engine engage again, but something else already did.  It bent space softly around you, and, maybe the rocket moved a little.  Like with a soft whoosh.  It happened in less than a second.  You think you're somewhere else.

Porcine Cluster
You are inside the rocket as it cruises very slowly through the deep, dark void of space.  Outside the porthole window is the deep, dark void of space covered over with a curtain of stars.

The the cockpit, a big metal unit containing a captain's chair and a control panel is here.

You notice something unusual outside the porthole window.

>press blue
Whoosh.  You thought maybe the engine engage again, but something else already did.  It bent space softly around you, and, maybe the rocket moved a little.  Like with a soft whoosh.  It happened in less than a second.  You think you're somewhere else.

Elbow Nebula
You are inside the rocket as it cruises very slowly through the deep, dark void of space.  Outside the porthole window is the deep, dark void of space covered over with a curtain of stars.

The the cockpit, a big metal unit containing a captain's chair and a control panel is here.

You notice something unusual outside the porthole window.

>press blue
Whoosh.  You thought maybe the engine engage again, but something else already did.  It bent space softly around you, and, maybe the rocket moved a little.  Like with a soft whoosh.  It happened in less than a second.  You think you're somewhere else.

Kamiro Quadrant
You are inside the rocket as it cruises very slowly through the deep, dark void of space.  Outside the porthole window is the deep, dark void of space covered over with a curtain of stars.

The the cockpit, a big metal unit containing a captain's chair and a control panel is here.

You notice something unusual outside the porthole window.

>look simian
You can't see any such thing.

I beg your pardon?

>look monkey
You can't see any such thing.

>tap glass
You can't see any such thing.

>tap porthole
Violence isn't the answer to this one.

I beg your pardon?

>i
You are carrying:
  a the cockpit, a big metal unit containing a captain's chair and a control panel

>i
You are carrying:
  a the cockpit, a big metal unit containing a captain's chair and a control panel

* * *

>i
You examine what you'd normally use to carry things, all the way from fingertip to elbow.  As you suspected, nothing is contained there.  You briefly check for pockets or some kind of fanny pack.  There isn't anything like that.  You are forced to conclude that you have no possessions.

>knock glass
You can't see any such thing.

>press blue
Whoosh.  You thought maybe the engine engage again, but something else already did.  It bent space softly around you, and, maybe the rocket moved a little.  Like with a soft whoosh.  It happened in less than a second.  You think you're somewhere else.

Chrysocolla Cluster
You are inside the rocket as it cruises very slowly through the deep, dark void of space.  Outside the porthole window is the deep, dark void of space covered over with a curtain of stars.

The the cockpit, a big metal unit containing a captain's chair and a control panel is here.

You notice something unusual outside the porthole window.

>knock on the glass
You startle the simian businessperson and they lose their concentration for one moment.  Their fingers whip forward towards you involuntarily, and you suddenly feel whatever they were holding in the palm of your own hand.  It is a shiny 1964 quarter.  The businessperson looks briefly dismayed but merely pulls something else out of its pocket.

>i
You are carrying:
  a shiny 1964 quarter

>look quarter
Before 1964, quarters were made almost entirely of silver, so the shine of this mint-condition coin is brilliant.  It is otherwise like a U.S. quarter dollar piece in general, with the date, 1964, and a small letter "D" representing the Denver Mint stamped into its surface.

>knock window
The simian businessperson flicks an eye towards you, but otherwise doesn't pay any attention.

* * *

>look under chair
HOLY COW THERE TURNS OUT TO BE A SPACE AGE OUTLET UNDERNEATH THE CAPTAINS CHAIR @TODO

>look under chair
There is a space-age outlet underneath the captain's chair.

>plug lite into outlet
You can't see any such thing.

>look outlet
ITS AN OUTLET @TODO

>get outlet
That seems to be a part of the captain's chair.

>look lite
You can't see any such thing.

* * *

>look window
You can't see any such thing.

>press blue button
There is only the soft click of the button's mechanism.  It might only work when the rocket has been launched.

>look window
You can't see any such thing.

>look jellyfish
You can't see any such thing.

>look tendrils
You can't see any such thing.

>look currents
You can't see any such thing.

>look current
You can't see any such thing.

>look body
You can't see any such thing.

* * *

>press blue button
Whoosh.  You thought maybe the engine engage again, but something else already did.  It bent space softly around you, and, maybe the rocket moved a little.  Like with a soft whoosh.  It happened in less than a second.  You think you're somewhere else.

Porcine Cluster
You are inside the rocket as it cruises very slowly through the deep, dark void of space.  Outside the porthole window is the deep, dark void of space covered over with a curtain of stars.

The the cockpit, a big metal unit containing a captain's chair and a control panel is here.

You notice something unusual outside the porthole window.

You can see a shiny 1964 quarter here.

>press blue button
Whoosh.  You thought maybe the engine engage again, but something else already did.  It bent space softly around you, and, maybe the rocket moved a little.  Like with a soft whoosh.  It happened in less than a second.  You think you're somewhere else.

Elbow Nebula
You are inside the rocket as it cruises very slowly through the deep, dark void of space.  Outside the porthole window is the deep, dark void of space covered over with a curtain of stars.

The the cockpit, a big metal unit containing a captain's chair and a control panel is here.

You notice something unusual outside the porthole window.

>look control panel
The control panel is an extremely austere, some might even say naive set of controls.  There is a large, shiny, red button labeled "Launch", a smaller black button that labeled "Return", and then off to your right, a medium-sized bright blue button labeled "Forward".  Finally, along the top is a small LED readout display that says "Elbow Nebula".

That's it.  Surely you should be able to operate a spacecraft with only those controls?  (You look on the front for a button marked "Fire Laser" or "Warp 7" but those buttons are not on the control panel or anywhere else inside the ship.)

I beg your pardon?

>press return button
Whoosh. At the end of the rocket's soft whoosh, its mighty engines begin to engage, slowing its fall as it pillows down to the landing pad in The Land of Launched Vessels.

The Inside of the Parked Rocket
You are within the smooth walls of the rocket.  It is very plain here, out the porthole window you can see the sky, and out the hatch you can see The Land of Launched Vessels.

>leave
You exit the hatch opening and climb to the ground.

The Land of Launched Vessels
You are in The Land of Launched Vessels.  There is a launchpad here, on which sits a large, 1950's era rocket in galaxy white and candy-apple red. The Spiritual Sequel Path leads backwards towards The Land of Unlaunched Vessels

You can see a launchpad and a Rocket here.

>climb ladder
You pull yourself into the rocket.

The Inside of the Parked Rocket
You are within the smooth walls of the rocket.  It is very plain here, out the porthole window you can see the sky, and out the hatch you can see The Land of Launched Vessels.

>press launch
It's natural to expect blastoff immediately.  Instead, the hatch door whirrs slowly shut, coming to a solid clang.  You have just enough time to realize that you could buckle yourself into the captain's chair and you do.  Just in time, as you feel a tremendous slow and steady thrust of force wrap itself around you as the sky begins to move in the porthole window.  For just one moment you swear you can see The Land of Breakfast and Lunch streak by the window.  Finally, the sky begins to darken, and all sound becomes only a vibration.  The deep, dark void of space is with you.  You absentmindedly unbuckle the webbing securing you to the seat, and you feel free to move about the interior.

The Deep, Dark Void of Space
You are inside the rocket as it cruises very slowly through the deep, dark void of space.  Outside the porthole window is the deep, dark void of space covered over with a curtain of stars.

The the cockpit, a big metal unit containing a captain's chair and a control panel is here.

>press forward
Whoosh.  You thought maybe the engine engage again, but something else already did.  It bent space softly around you, and, maybe the rocket moved a little.  Like with a soft whoosh.  It happened in less than a second.  You think you're somewhere else.

Kamiro Quadrant
You are inside the rocket as it cruises very slowly through the deep, dark void of space.  Outside the porthole window is the deep, dark void of space covered over with a curtain of stars.

The the cockpit, a big metal unit containing a captain's chair and a control panel is here.

You notice something unusual outside the porthole window.

I beg your pardon?

>press forward
Whoosh.  You thought maybe the engine engage again, but something else already did.  It bent space softly around you, and, maybe the rocket moved a little.  Like with a soft whoosh.  It happened in less than a second.  You think you're somewhere else.

Elbow Nebula
You are inside the rocket as it cruises very slowly through the deep, dark void of space.  Outside the porthole window is the deep, dark void of space covered over with a curtain of stars.

The the cockpit, a big metal unit containing a captain's chair and a control panel is here.

You notice something unusual outside the porthole window.

>press forward
Whoosh.  You thought maybe the engine engage again, but something else already did.  It bent space softly around you, and, maybe the rocket moved a little.  Like with a soft whoosh.  It happened in less than a second.  You think you're somewhere else.

Elbow Nebula
You are inside the rocket as it cruises very slowly through the deep, dark void of space.  Outside the porthole window is the deep, dark void of space covered over with a curtain of stars.

The the cockpit, a big metal unit containing a captain's chair and a control panel is here.

You notice something unusual outside the porthole window.

>press forward
Whoosh.  You thought maybe the engine engage again, but something else already did.  It bent space softly around you, and, maybe the rocket moved a little.  Like with a soft whoosh.  It happened in less than a second.  You think you're somewhere else.

Kamiro Quadrant
You are inside the rocket as it cruises very slowly through the deep, dark void of space.  Outside the porthole window is the deep, dark void of space covered over with a curtain of stars.

The the cockpit, a big metal unit containing a captain's chair and a control panel is here.

You notice something unusual outside the porthole window.

>press forward
Whoosh.  You thought maybe the engine engage again, but something else already did.  It bent space softly around you, and, maybe the rocket moved a little.  Like with a soft whoosh.  It happened in less than a second.  You think you're somewhere else.

Kamiro Quadrant
You are inside the rocket as it cruises very slowly through the deep, dark void of space.  Outside the porthole window is the deep, dark void of space covered over with a curtain of stars.

The the cockpit, a big metal unit containing a captain's chair and a control panel is here.

You notice something unusual outside the porthole window.

>press forward
Whoosh.  You thought maybe the engine engage again, but something else already did.  It bent space softly around you, and, maybe the rocket moved a little.  Like with a soft whoosh.  It happened in less than a second.  You think you're somewhere else.

Porcine Cluster
You are inside the rocket as it cruises very slowly through the deep, dark void of space.  Outside the porthole window is the deep, dark void of space covered over with a curtain of stars.

The the cockpit, a big metal unit containing a captain's chair and a control panel is here.

You notice something unusual outside the porthole window.

You can see a shiny 1964 quarter here.

* * *

>sit chair
I didn't understand that sentence.

>sit in chair
You settle into the captain's chair, and really feel Captain-ey immediately.  You practice buckling yourself into the protective webbing, and unbuckling it.  You get up eventually.  Now, when you are about to launch or land you will know what to do.

>enter chair
You settle into the captain's chair, and really feel Captain-ey immediately.  You practice buckling yourself into the protective webbing, and unbuckling it.  You get up eventually.  Now, when you are about to launch or land you will know what to do.

* * *

>wave
You wave your little heart out, but that doesn't get the space jellyfish's attention.  There's got to be some way.

>wave at jellyfish
You wave your little heart out, but that doesn't get the space jellyfish's attention.  There's got to be some way.

>tap on glass
You hit the porthole window but it doesn't seem to affect the space jellyfish.  There's got to be some way to get the space jellyfish's attention.

>press blue
Whoosh.  You thought maybe the engine engaged again, but something else already did.  It bent space softly around you, and, maybe the rocket moved a little.  Like with a soft whoosh.  It happened in less than a second.  Now, you think you're somewhere else.

Kamiro Quadrant
You are inside the rocket as it cruises very slowly through the deep, dark void of space.  Outside the porthole window is the deep, dark void of space covered over with a curtain of stars.

You notice something unusual outside the porthole window.

>press blue
Whoosh.  You thought maybe the engine engaged again, but something else already did.  It bent space softly around you, and, maybe the rocket moved a little.  Like with a soft whoosh.  It happened in less than a second.  Now, you think you're somewhere else.

Chrysocolla Cluster
You are inside the rocket as it cruises very slowly through the deep, dark void of space.  Outside the porthole window is the deep, dark void of space covered over with a curtain of stars.

You notice something unusual outside the porthole window.

>talk to the simian
The simian businessperson is not going to be able to understand anything you say through the vacuum of space.   Doesn't seem to notice your mouth moving.

>ask simian about face
The simian businessperson is not going to be able to understand anything you say through the vacuum of space.   Doesn't seem to notice your mouth moving.

>ask simian about self
The simian businessperson is not going to be able to understand anything you say through the vacuum of space.   Doesn't seem to notice your mouth moving.

>ask simian about self
The simian businessperson is not going to be able to understand anything you say through the vacuum of space.   Doesn't seem to notice your mouth moving.

* * *

>x window
Just outside the window is a simian businessperson, with a tidy leather jetpack.  Behind them is a curtain of stars.

>x space
You can't see any such thing.

>press return
Whoosh. At the end of the rocket's soft whoosh, its mighty engines begin to engage, slowing its fall as it pillows down to the landing pad in The Land of Once Launched Vessels.

The Inside of the Parked Rocket
You are within the smooth walls of the rocket.  It is very plain here, out the porthole window you can see the sky, and out the hatch you can see The Land of Once Launched Vessels.

>exit
You exit the hatch opening and climb to the ground.

The Land of Once Launched Vessels
You are in The Land of Once Launched Vessels.  There is a launchpad here, on which sits a large, 1950's era rocket in galaxy white and candy-apple red. The Spiritual Sequel Path leads backwards towards The Land of Unlaunched Vessels

You can see a launchpad and a Rocket here.

>f
The anticlimactic path.
You are on the anticlimactic path.  Backwards is The Land of Once Launched Vessels.  Ahead of you, you can see the back of the liquor store.

>f
Behind the liquor store
You've got your standard collection of broken down boxes, a dumpster, and a stack of pallets.  Behind you, the anticlimactic path leads to The Land of Once Launched Vessels.

>f
The path around the liquor store
You're on the path around the liquor store.  You see the side of the liquor store on one side and a fence on the other side.

* * *

>f
The front of the liquor store
The liquor store is closed, looks like permanantly, and there's just a weird humvee kiddie ride here.

You can see a kiddie ride here.

>turn on kiddie ride
The way to turn on the kiddie ride is to put a quarter into the coin slot.

* * *

>look
Elbow Nebula
You are inside the rocket as it cruises very slowly through the deep, dark void of space.  Outside the porthole window is the deep, dark void of space covered over with a curtain of stars.

You notice something unusual outside the porthole window.

You can see a cockpit, a big metal unit containing a captain's chair and a control panel here.

>press blue
Whoosh.  You thought maybe the engine engaged again, but something else already did.  It bent space softly around you, and, maybe the rocket moved a little.  Like with a soft whoosh.  It happened in less than a second.  Now, you think you're somewhere else.

Kamiro Quadrant
You are inside the rocket as it cruises very slowly through the deep, dark void of space.  Outside the porthole window is the deep, dark void of space covered over with a curtain of stars.

You notice something unusual outside the porthole window.

* * *

>press blue
Whoosh.  You thought maybe the engine engaged again, but something else already did.  It bent space softly around you, and, maybe the rocket moved a little.  Like with a soft whoosh.  It happened in less than a second.  Now, you think you're somewhere else.

Chrysocolla Cluster
You are inside the rocket as it cruises very slowly through the deep, dark void of space.  Outside the porthole window is the deep, dark void of space covered over with a curtain of stars.

You notice something unusual outside the porthole window.

>press blue
Whoosh.  You thought maybe the engine engaged again, but something else already did.  It bent space softly around you, and, maybe the rocket moved a little.  Like with a soft whoosh.  It happened in less than a second.  Now, you think you're somewhere else.

The Deep, Dark Void of Space
You are inside the rocket as it cruises very slowly through the deep, dark void of space.  Outside the porthole window is the deep, dark void of space covered over with a curtain of stars.

>press blue
Whoosh.  You thought maybe the engine engaged again, but something else already did.  It bent space softly around you, and, maybe the rocket moved a little.  Like with a soft whoosh.  It happened in less than a second.  Now, you think you're somewhere else.

Elbow Nebula
You are inside the rocket as it cruises very slowly through the deep, dark void of space.  Outside the porthole window is the deep, dark void of space covered over with a curtain of stars.

You notice something unusual outside the porthole window.

>press
What do you want to press?

>press blue
Whoosh.  You thought maybe the engine engaged again, but something else already did.  It bent space softly around you, and, maybe the rocket moved a little.  Like with a soft whoosh.  It happened in less than a second.  Now, you think you're somewhere else.

Kamiro Quadrant
You are inside the rocket as it cruises very slowly through the deep, dark void of space.  Outside the porthole window is the deep, dark void of space covered over with a curtain of stars.

You notice something unusual outside the porthole window.

* * *

>press blue
Whoosh.  You thought maybe the engine engaged again, but something else already did.  It bent space softly around you, and, maybe the rocket moved a little.  Like with a soft whoosh.  It happened in less than a second.  Now, you think you're somewhere else.

The Deep, Dark Void of Space
You are inside the rocket as it cruises very slowly through the deep, dark void of space.  Outside the porthole window is the deep, dark void of space covered over with a curtain of stars.

>look outlet
ITS AN OUTLET @TODO

>plug lite into outlet
You plug the lite-brite into the outlet.

The light in the lite-brite springs to life.  It is an odd, orange-tinted bulb.

>get page
You carefully tear the last page out.  It's actually perforated, so you don't feel so bad.

>put page into outlet
That can't contain things.

>put page into lite
You slide the last page into the lite-brite, activating the glowing ink on the coloring book page.  A luminous horse party begins to glow on the page.

>plug lite into outlet
You plug the lite-brite into the outlet.

@TODO IT LIGHTS UP but does not delight the jellyfish.

>i
You are carrying:
  a small hobby horse
  a small heart shaped locket (closed)
  a coloring book
  a closed jack-in-the-box
  a skinny naked plastic doll
  a wooden block

>look
The Deep, Dark Void of Space
You are inside the rocket as it cruises very slowly through the deep, dark void of space.  Outside the porthole window is the deep, dark void of space covered over with a curtain of stars.

You can see a lite-brite (in which is a last page from the coloring book, black, and printed with some kind of glow-in-the-dark ink) and a cockpit, a big metal unit containing a captain's chair and a control panel here.

>press forward
Whoosh.  You thought maybe the engine engaged again, but something else already did.  It bent space softly around you, and, maybe the rocket moved a little.  Like with a soft whoosh.  It happened in less than a second.  Now, you think you're somewhere else.

Elbow Nebula
You are inside the rocket as it cruises very slowly through the deep, dark void of space.  Outside the porthole window is the deep, dark void of space covered over with a curtain of stars.

You notice something unusual outside the porthole window.

The jellyfish is delighted! @TODO.

>unplug lite
You unplug the lite-brite.

>i
You are carrying:
  a small hobby horse
  a small heart shaped locket (closed)
  a coloring book
  a closed jack-in-the-box
  a skinny naked plastic doll
  a wooden block

>look
Elbow Nebula
You are inside the rocket as it cruises very slowly through the deep, dark void of space.  Outside the porthole window is the deep, dark void of space covered over with a curtain of stars.

You notice something unusual outside the porthole window.

You can see a lite-brite (in which is a last page from the coloring book, black, and printed with some kind of glow-in-the-dark ink) and a cockpit, a big metal unit containing a captain's chair and a control panel here.

>press forward
Whoosh.  You thought maybe the engine engaged again, but something else already did.  It bent space softly around you, and, maybe the rocket moved a little.  Like with a soft whoosh.  It happened in less than a second.  Now, you think you're somewhere else.

Kamiro Quadrant
You are inside the rocket as it cruises very slowly through the deep, dark void of space.  Outside the porthole window is the deep, dark void of space covered over with a curtain of stars.

You notice something unusual outside the porthole window.

>look
Kamiro Quadrant
You are inside the rocket as it cruises very slowly through the deep, dark void of space.  Outside the porthole window is the deep, dark void of space covered over with a curtain of stars.

You notice something unusual outside the porthole window.

You can see a lite-brite (in which is a last page from the coloring book, black, and printed with some kind of glow-in-the-dark ink) and a cockpit, a big metal unit containing a captain's chair and a control panel here.

>look
Kamiro Quadrant
You are inside the rocket as it cruises very slowly through the deep, dark void of space.  Outside the porthole window is the deep, dark void of space covered over with a curtain of stars.

You notice something unusual outside the porthole window.

You can see a lite-brite (in which is a last page from the coloring book, black, and printed with some kind of glow-in-the-dark ink) and a cockpit, a big metal unit containing a captain's chair and a control panel here.

>i
You are carrying:
  a small hobby horse
  a small heart shaped locket (closed)
  a coloring book
  a closed jack-in-the-box
  a skinny naked plastic doll
  a wooden block

I beg your pardon?

>press forward
Whoosh.  You thought maybe the engine engaged again, but something else already did.  It bent space softly around you, and, maybe the rocket moved a little.  Like with a soft whoosh.  It happened in less than a second.  Now, you think you're somewhere else.

Chrysocolla Cluster
You are inside the rocket as it cruises very slowly through the deep, dark void of space.  Outside the porthole window is the deep, dark void of space covered over with a curtain of stars.

You notice something unusual outside the porthole window.

>g
Whoosh.  You thought maybe the engine engaged again, but something else already did.  It bent space softly around you, and, maybe the rocket moved a little.  Like with a soft whoosh.  It happened in less than a second.  Now, you think you're somewhere else.

The Deep, Dark Void of Space
You are inside the rocket as it cruises very slowly through the deep, dark void of space.  Outside the porthole window is the deep, dark void of space covered over with a curtain of stars.

>g
Whoosh.  You thought maybe the engine engaged again, but something else already did.  It bent space softly around you, and, maybe the rocket moved a little.  Like with a soft whoosh.  It happened in less than a second.  Now, you think you're somewhere else.

Elbow Nebula
You are inside the rocket as it cruises very slowly through the deep, dark void of space.  Outside the porthole window is the deep, dark void of space covered over with a curtain of stars.

You notice something unusual outside the porthole window.

>look
Elbow Nebula
You are inside the rocket as it cruises very slowly through the deep, dark void of space.  Outside the porthole window is the deep, dark void of space covered over with a curtain of stars.

You notice something unusual outside the porthole window.

You can see a lite-brite (in which is a last page from the coloring book, black, and printed with some kind of glow-in-the-dark ink) and a cockpit, a big metal unit containing a captain's chair and a control panel here.

>look through window
There is a giant space jellyfish made of light here.  It's not an actual jellyfish, but that's the closest thing you can think of to call it.  Behind it is a curtain of stars.

>i
You are carrying:
  a small hobby horse
  a small heart shaped locket (closed)
  a coloring book
  a closed jack-in-the-box
  a skinny naked plastic doll
  a wooden block

>plug lite into outlet
You plug the lite-brite into the outlet.

@TODO IT LIGHTS UP but does not delight the jellyfish.

>look monkey
You can't see any such thing.

* * *

>look under chair
HOLY COW THERE TURNS OUT TO BE A SPACE AGE OUTLET UNDERNEATH THE CAPTAINS CHAIR @TODO

>plug lite into outlet
You plug the lite-brite into the outlet.

The light in the lite-brite springs to life.  It is an odd, orange-tinted bulb.

>unplug lite
You unplug the lite-brite.

>put page in lite
Only a single piece of paper would slide into the lite-brite.

>plug lite into outlet
You plug the lite-brite into the outlet.

The light in the lite-brite springs to life.  It is an odd, orange-tinted bulb.

>take page
You carefully tear the last page out.  It's actually perforated, so you don't feel so bad.

>put page in lite
You slide the last page into the lite-brite, activating the glowing ink on the coloring book page.  A luminous horse party begins to glow on the page.

>look
The Deep, Dark Void of Space
You are inside the rocket as it cruises very slowly through the deep, dark void of space.  Outside the porthole window is the deep, dark void of space covered over with a curtain of stars.

You can see a lite-brite (in which is a last page from the coloring book, black, and printed with some kind of glow-in-the-dark ink) and a cockpit, a big metal unit containing a captain's chair and a control panel here.

I beg your pardon?

>take page
Taken.

>press forward
Whoosh.  You thought maybe the engine engaged again, but something else already did.  It bent space softly around you, and, maybe the rocket moved a little.  Like with a soft whoosh.  It happened in less than a second.  Now, you think you're somewhere else.

Elbow Nebula
You are inside the rocket as it cruises very slowly through the deep, dark void of space.  Outside the porthole window is the deep, dark void of space covered over with a curtain of stars.

You notice something unusual outside the porthole window.

>put page in lite
You slide the last page into the lite-brite, activating the glowing ink on the coloring book page.  A luminous horse party begins to glow on the page.
The jellyfish is delighted! @TODO.

>get page
Taken.

>look lite
You're looking at a white plastic case with a black plastic pegboard covering one side.   Attached to the back is a black power cord.  It's got a little lightbulb inside, and usually comes with sheets of black construction paper to affix to the pegboard.  Usually comes with dozens of transparent, colored pegs too.  If you had them, you'd push the pegs into the pegboard to make little light-up pictures.You don't see any of that stuff though.

>i
You are carrying:
  a last page from the coloring book, black, and printed with some kind of glow-in-the-dark ink
  a small hobby horse
  a small heart shaped locket (closed)
  a coloring book
  a closed jack-in-the-box
  a skinny naked plastic doll
  a wooden block

>look
Elbow Nebula
You are inside the rocket as it cruises very slowly through the deep, dark void of space.  Outside the porthole window is the deep, dark void of space covered over with a curtain of stars.

You notice something unusual outside the porthole window.

You can see a lite-brite (empty) and a cockpit, a big metal unit containing a captain's chair and a control panel here.

>look under chair
There is a space-age outlet underneath the captain's chair.

>look outlet
ITS AN OUTLET @TODO

>look lite
You're looking at a white plastic case with a black plastic pegboard covering one side.   Attached to the back is a black power cord.  It's got a little lightbulb inside, and usually comes with sheets of black construction paper to affix to the pegboard.  Usually comes with dozens of transparent, colored pegs too.  If you had them, you'd push the pegs into the pegboard to make little light-up pictures.You don't see any of that stuff though.

>press land
You can't see any such thing.

>press land
You can't see any such thing.

* * *

>press return
Whoosh. At the end of the rocket's soft whoosh, its mighty engines begin to engage, slowing its fall as it pillows down to the landing pad in The Land of Once Launched Vessels.

The Inside of the Parked Rocket
You are within the smooth walls of the rocket.  It is very plain here, out the porthole window you can see the sky, and out the hatch you can see The Land of Once Launched Vessels.

>press launch
It's natural to expect blastoff immediately.  Instead, the hatch door whirrs slowly shut, coming to a solid clang.  You have just enough time to realize that you could buckle yourself into the captain's chair and you do.  Just in time, as you feel a tremendous slow and steady thrust of force wrap itself around you as the sky begins to move in the porthole window.  For just one moment you swear you can see The Land of Breakfast and Lunch streak by the window.  Finally, the sky begins to darken, and all sound becomes only a vibration.  The deep, dark void of space is with you.  You absentmindedly unbuckle the webbing securing you to the seat, and you feel free to move about the interior.

The Deep, Dark Void of Space
You are inside the rocket as it cruises very slowly through the deep, dark void of space.  Outside the porthole window is the deep, dark void of space covered over with a curtain of stars.

>get lite
You can't see any such thing.

>i
You are carrying:
  a last page from the coloring book, black, and printed with some kind of glow-in-the-dark ink
  a small hobby horse
  a small heart shaped locket (closed)
  a coloring book
  a closed jack-in-the-box
  a skinny naked plastic doll
  a wooden block

>push forward
Whoosh.  You thought maybe the engine engaged again, but something else already did.  It bent space softly around you, and, maybe the rocket moved a little.  Like with a soft whoosh.  It happened in less than a second.  Now, you think you're somewhere else.

Elbow Nebula
You are inside the rocket as it cruises very slowly through the deep, dark void of space.  Outside the porthole window is the deep, dark void of space covered over with a curtain of stars.

You notice something unusual outside the porthole window.

You can see a lite-brite (empty) here.

>push forward
Whoosh.  You thought maybe the engine engaged again, but something else already did.  It bent space softly around you, and, maybe the rocket moved a little.  Like with a soft whoosh.  It happened in less than a second.  Now, you think you're somewhere else.

Kamiro Quadrant
You are inside the rocket as it cruises very slowly through the deep, dark void of space.  Outside the porthole window is the deep, dark void of space covered over with a curtain of stars.

You notice something unusual outside the porthole window.

>look
Kamiro Quadrant
You are inside the rocket as it cruises very slowly through the deep, dark void of space.  Outside the porthole window is the deep, dark void of space covered over with a curtain of stars.

You notice something unusual outside the porthole window.

You can see a lite-brite (empty) and a cockpit, a big metal unit containing a captain's chair and a control panel here.

>push forward
Whoosh.  You thought maybe the engine engaged again, but something else already did.  It bent space softly around you, and, maybe the rocket moved a little.  Like with a soft whoosh.  It happened in less than a second.  Now, you think you're somewhere else.

Chrysocolla Cluster
You are inside the rocket as it cruises very slowly through the deep, dark void of space.  Outside the porthole window is the deep, dark void of space covered over with a curtain of stars.

You notice something unusual outside the porthole window.

>look
Chrysocolla Cluster
You are inside the rocket as it cruises very slowly through the deep, dark void of space.  Outside the porthole window is the deep, dark void of space covered over with a curtain of stars.

You notice something unusual outside the porthole window.

You can see a lite-brite (empty) and a cockpit, a big metal unit containing a captain's chair and a control panel here.

>get lite
You unplug the lite-brite.

Taken.

>look
Chrysocolla Cluster
You are inside the rocket as it cruises very slowly through the deep, dark void of space.  Outside the porthole window is the deep, dark void of space covered over with a curtain of stars.

You notice something unusual outside the porthole window.

You can see a cockpit, a big metal unit containing a captain's chair and a control panel here.

>push forward
Whoosh.  You thought maybe the engine engaged again, but something else already did.  It bent space softly around you, and, maybe the rocket moved a little.  Like with a soft whoosh.  It happened in less than a second.  Now, you think you're somewhere else.

The Deep, Dark Void of Space
You are inside the rocket as it cruises very slowly through the deep, dark void of space.  Outside the porthole window is the deep, dark void of space covered over with a curtain of stars.

>i
You are carrying:
  a lite-brite
  a last page from the coloring book, black, and printed with some kind of glow-in-the-dark ink
  a small hobby horse
  a small heart shaped locket (closed)
  a coloring book
  a closed jack-in-the-box
  a skinny naked plastic doll
  a wooden block

* * *

>test talkseaperson
(Testing.)

>[1] f

The Land of Breakfast and Lunch
The Land of Breakfast and Lunch is a lot smaller than you were expecting.  It's actually just a small clearing near the road, like a roadside stop, with a painted picnic table containing a simple but nourishing breakfast on one end, and a simple but nourishing lunch on the other end.  A stubby little path leads backwards, and the path continues forward, towards The Land of Unrealized Possibilities.  If you "walk forward" or just "forward" or even just "f" you will be walking towards it.

You can see a painted picnic table (on which are Breakfast and Lunch) here.

>[2] f

Hopeful Path
You are on the hopeful path.  Backwards from here is The Land of Breakfast and Lunch.  Forward is The Land of Unrealized Possibilities.

>[3] f

The Land of Unrealized Possibilities
You are in the Land of Unrealized Possibilities.  Just being here gives you a sense of all that could be accomplished if enough time, effort, and focus were pointed in a specific direction.  There is a sense of both excitement and disappointment here that is almost palpable.  The Hopeful Path leads backward towards The Land of Breakfast and Lunch, a place with a much clearer sense of purpose.  The Seaside Path leads forward, towards The Land of Unlaunched Vessels.

You can see a toy box (closed), a couch (on which is your brother), and a TV here.

>[4] f

Seaside Path
You are on the seaside path.  Backwards from here is The Land of Unrealized Possibilities.  Forward is The Land of Unlaunched Vessels.

>[5] f

The Land of Unlaunched Vessels
You are in The Land of Unlaunched Vessels.  You stand near the edge of the bay, and there is a sailing ship moored here with thick and aged ropes tied to a bollard.  The Hopeful Path leads backward towards The Land of Unrealized Possibilities, a place you're not sure you want to be.  Forward, Sequel Path leads to The Land of Unlaunched Vessels II: The Launchening.

You can see a swarthy hippie seaperson here.

>[6] ask seaperson about bollard
"Ah yeah, that's a mooring bollard."

>[7] ask seaperson about fluyt
"Yes, that's The Chimera.  It's a Dutch cargo fluyt.  Due to a trade dispute it's temporarily moored here since it can't legally be moored at any real harbor.  I am required to ensure it isn't stolen and that no one boards it, but otherwise I don't have much else to do.  That's ok though, I do not mind resting in the sun day after day.  I've worked hard all my life and I'm fine being right here in The Land of Unlaunched Vessels.  If The Chimera ever launched, I believe we'd have to change the name of the place."

>[8] ask seaperson about trade dispute
"The trade dispute began about four years ago, and The Chimera has been moored here in this temporary location nearly that entire time.  First time I've ever been paid NOT to sail.  I think someone in The Land of Taxable Interest got a little rowdy, and someone in The Land of Sensible Tariffs took exception.

I beg your pardon?

>ask seaperson about ropes
"Technically you would call them line, or mooring warps.  Landlubbers call them ropes though."

>ask seaperson about trade
"The trade dispute began about four years ago, and The Chimera has been moored here in this temporary location nearly that entire time.  First time I've ever been paid NOT to sail.  I think someone in The Land of Taxable Interest got a little rowdy, and someone in The Land of Sensible Tariffs took exception.

* * *

>ask seaperson about trade
"Sorry, I do not know about that."

>ask seaperson about dispute
"Sorry, I do not know about that."

* * *

>test toy box
I only understood you as far as wanting to test that.

>test toybox
(Testing.)

>[1] f

The Land of Breakfast and Lunch
The Land of Breakfast and Lunch is a lot smaller than you were expecting.  It's actually just a small clearing near the road, like a roadside stop, with a painted picnic table containing a simple but nourishing breakfast on one end, and a simple but nourishing lunch on the other end.  A stubby little path leads backwards, and the path continues forward, towards The Land of Unrealized Possibilities.  If you "walk forward" or just "forward" or even just "f" you will be walking towards it.

You can see a painted picnic table (on which are Breakfast and Lunch) here.

>[2] f

Hopeful Path
You are on the hopeful path.  Backwards from here is The Land of Breakfast and Lunch.  Forward is The Land of Unrealized Possibilities.

>[3] f

The Land of Unrealized Possibilities
You are in the Land of Unrealized Possibilities.  Just being here gives you a sense of all that could be accomplished if enough time, effort, and focus were pointed in a specific direction.  There is an sense of both excitement and disappointment here that is almost palpable.  The Hopeful Path leads backward towards The Land of Breakfast and Lunch, a place with a much clearer sense of purpose.

You can see a toy box (closed), a couch (on which is your brother), a TV, and a kiddie ride here.

>[4] open box
(the toy box)
You open the toy box, revealing a wooden block, a skinny naked plastic doll, a jack-in-the-box, a lite-brite, a coloring book, a small heart shaped locket, and a small hobby horse.

>[5] x doll
The face of the skinny plastic doll is forever frozen in an expression of bored self-satisfaction.  Its long naked arms and legs bend and articulate, but not much.  Its breasts are idealized, yet awkwardly shaped, like rounded pyramids.  It has nylon synthetic hair that cascades stiffly around its shoulders.

>[6] x hair
The hair is really tiny tufts of nylon that poke out of holes in the doll's hair.

>[7] x breasts
They are merely designed to fill out a miniature blouse, and look very unnatural unclothed.

>[8] bend doll
You twist the doll into a few unlikely positions, as if getting to horrify an imaginary younger sister.  Then, you are bored and bend her back to her awkwardly stiff standing pose.

>[9] x jack-in-the-box
yo

>[10] x lite-brite
yo

>[11] x coloring book
yo

>look box
(the toy box)
It is a large simple wooden toy box stained with a nice hand-painted varnish.  It has a hinged lid on top.

In the toy box are a wooden block, a skinny naked plastic doll, a jack-in-the-box, a lite-brite, a coloring book, a small heart shaped locket, and a small hobby horse.

>bend doll
You twist the doll into a few unlikely positions, as if getting to horrify an imaginary younger sister.  Then, you are bored and bend her back to her awkwardly stiff standing pose.

>bend block
You twist the doll into a few unlikely positions, as if getting to horrify an imaginary younger sister.  Then, you are bored and bend her back to her awkwardly stiff standing pose.

>open box
(the toy box)
That's already open.

>look block
It is a simple block made out of wood.  It is an unpainted cube, with very slightly rounded corners.  It's the kind of thing you would find at a Montessouri school, usually in the company of many of its compatriots.  This one is alone.

>get block
Taken.

>bend block
You twist the doll into a few unlikely positions, as if getting to horrify an imaginary younger sister.  Then, you are bored and bend her back to her awkwardly stiff standing pose.

>look arms
The face of the skinny plastic doll is forever frozen in an expression of bored self-satisfaction.  Its long naked arms and legs bend and articulate, but not much.  Its breasts are idealized, yet awkwardly shaped, like rounded pyramids.  It has nylon synthetic hair that cascades stiffly around its shoulders.

>look hair
The hair is really tiny tufts of nylon that poke out of holes in the doll's hair.

>look breasts
They are merely designed to fill out a miniature blouse, and look very unnatural unclothed.

>bend arms
You twist the doll into a few unlikely positions, as if getting to horrify an imaginary younger sister.  Then, you are bored and bend her back to her awkwardly stiff standing pose.

* * *

>test toybox
(Testing.)

>[1] f

The Land of Breakfast and Lunch
The Land of Breakfast and Lunch is a lot smaller than you were expecting.  It's actually just a small clearing near the road, like a roadside stop, with a painted picnic table containing a simple but nourishing breakfast on one end, and a simple but nourishing lunch on the other end.  A stubby little path leads backwards, and the path continues forward, towards The Land of Unrealized Possibilities.  If you "walk forward" or just "forward" or even just "f" you will be walking towards it.

You can see a painted picnic table (on which are Breakfast and Lunch) here.

>[2] f

Hopeful Path
You are on the hopeful path.  Backwards from here is The Land of Breakfast and Lunch.  Forward is The Land of Unrealized Possibilities.

>[3] f

The Land of Unrealized Possibilities
You are in the Land of Unrealized Possibilities.  Just being here gives you a sense of all that could be accomplished if enough time, effort, and focus were pointed in a specific direction.  There is an sense of both excitement and disappointment here that is almost palpable.  The Hopeful Path leads backward towards The Land of Breakfast and Lunch, a place with a much clearer sense of purpose.

You can see a toy box (closed), a couch (on which is your brother), a TV, and a kiddie ride here.

>[4] open box
(the toy box)
You open the toy box, revealing a wooden block, a skinny naked plastic doll, a closed jack-in-the-box, a lite-brite, a coloring book, a small heart shaped locket, and a small hobby horse.

>[5] x doll
The face of the skinny plastic doll is forever frozen in an expression of bored self-satisfaction.  Its long naked arms and legs bend and articulate, but not much.  Its breasts are idealized, yet awkwardly shaped, like rounded pyramids.  It has nylon synthetic hair that cascades stiffly around its shoulders.

>[6] x hair
The hair is really tiny tufts of nylon that poke out of holes in the doll's head.

>[7] x breasts
They are merely designed to fill out a miniature blouse, and look very unnatural unclothed.

>[8] bend doll
Taken.

You twist the doll into a few unlikely positions, as if getting ready to horrify an imaginary younger sister.  Then, you are bored and bend her back to her awkwardly stiff standing pose.

>[9] x jack-in-the-box
The jack-in-the-box is a brightly painted tin cube, and actually looks to be some sort of antique.  It is detailed with flames, and written on the back and front are the words "diable en bote".  It has a tightly fitted lid on top, and a small wire and wood hand crank on one side.

>[10] x lite-brite
yo

>[11] x coloring book
yo

I beg your pardon?

>bend hair
You can't see any such thing.

>bend block
You can't see any such thing.

>i
You are carrying:
  a skinny naked plastic doll

* * *

>test tuxedo
(Testing.)

I beg your pardon?

>get block
Taken.

* * *

>throw block
Dropped.

I beg your pardon?

>kick misyer
You can't see any such thing.

>kick mister
Whoa there, let's just pretend you're not the kind of person to attack a young, hopeful puppy.  Anyway, Mister Tuxedo is a lot faster than you.

>get block
You already have that.

>i
You are carrying:
  a wooden block

>throw block
@TODO

>throw block
@TODO

I beg your pardon?

>get block
You already have that.

>throw block
@TODO

* * *

>test tuxedo
(Testing.)

>get block
Taken.

* * *

>test tuxedo
(Testing.)

>hit mister
Whoa there, let's just pretend you're not the kind of person to attack a young, hopeful puppy.  Anyway, Mister Tuxedo is a lot faster than you.

>pet mister
Mister Tuxedo is too excited to settle down and be affectionate.  He's in more of a prancing, cavorting, chasing things mood right now.

>pet tuxedo
Mister Tuxedo is too excited to settle down and be affectionate.  He's in more of a prancing, cavorting, chasing things mood right now.

>pet mister tuxedo
Mister Tuxedo is too excited to settle down and be affectionate.  He's in more of a prancing, cavorting, chasing things mood right now.

>kiss tuxed
You can't see any such thing.

>kiss tuxedo
Mister Tuxedo is too excited to settle down and be affectionate.  He's in more of a prancing, cavorting, chasing things mood right now.

>x mister
Mister Tuxedo is a young, healthy dog in the very prime of his life.  He's black all over except the tips of his front paws, and the bottom of his chin and belly, giving him the appearance of permanent formalwear.  He is a very handsome dog, and his honoric (Mister) is never abbreviated as "Mr.".  You can call him "Mister" or "Tuxedo", but not "Mr." or "Mr. Tuxedo".  It's for a good reason, I promise.

Mister Tuxedo lives only to leap, cavort, and catch a thrown ball.

>throw tuxedo
Mister Tuxedo is already here.

>get tuxedo
Mister Tuxedo is too excited to settle down and be affectionate.  He's in more of a prancing, cavorting, chasing things mood right now.

>i
You examine what you'd normally use to carry things, all the way from fingertip to elbow.  As you suspected, nothing is contained there.  You briefly check for pockets or some kind of fanny pack.  There isn't anything like that.  You are forced to conclude that you have no possessions.

>throw
(Mister Tuxedo)
Mister Tuxedo is already here.

* * *

>test tuxedo
(Testing.)

>i
You examine what you'd normally use to carry things, all the way from fingertip to elbow.  As you suspected, nothing is contained there.  You briefly check for pockets or some kind of fanny pack.  There isn't anything like that.  You are forced to conclude that you have no possessions.

>look
The Land of Puppy Cardiovascular Health
The meadows are wide and rolling here.  Mister Tuxedo leaps and cavorts excitedly, barking every now and again.

You can see a wooden block, a post, and a power outlet here.

>get block
Taken.

>throw block
You check to make sure Mister Tuxedo is looking, and then you whip the wooden block as far as you can.

>i
You examine what you'd normally use to carry things, all the way from fingertip to elbow.  As you suspected, nothing is contained there.  You briefly check for pockets or some kind of fanny pack.  There isn't anything like that.  You are forced to conclude that you have no possessions.

* * *

>i
You are carrying:
  a wooden block

>throw block
You check to make sure Mister Tuxedo is looking, and then you whip the wooden block as far as you can
You give the wooden block a little toss and it lands on the ground harmlessly a few feet away.

>throw block
Just like your grandma used to say: you have to be holding the wooden block before you can throw the wooden block.

* * *

>get block
Taken.

>throw block
You check to make sure Mister Tuxedo is looking, and then you whip the wooden block as far as you can
You give the wooden block a little toss and it lands on the ground harmlessly a few feet away.

>i
You examine what you'd normally use to carry things, all the way from fingertip to elbow.  As you suspected, nothing is contained there.  You briefly check for pockets or some kind of fanny pack.  There isn't anything like that.  You are forced to conclude that you have no possessions.

>s
Idyllic Path
You are on the idyllic path.  Backwards from here is the liquor store, probably.  Forward is The Land of Puppy Cardiovascular Health.

>s
The Land in Front of the Liquor Store
The Land in Front of the Liquor Store looks mostly abandoned, and you feel a slight sense of disappointment and dread here.  The liquor store is closed, looks like permanently, and there's just a weird kiddie ride here.  There are marks on the sidewalk where some other metal vending machines were, but it looks like they've been carted away.  Only the kiddie ride remains.  It's pretty depressing here, but if you continue to go forward, the Idyllic Path leads to The Land of Puppy Cardiovascular health, which is the H.

You can see a kiddie ride here.

>s
The Path Around the Liquor Store
You're on the path around the liquor store.  You see the side of the liquor store on one side and a fence on the other side.

* * *

>s
The Land Behind the Liquor Store
You are in The Land Behind the Liquor Store.  It's underwhelming.  You've got your standard collection of broken down boxes, a dumpster, and a stack of pallets.  Behind you, the anticlimactic path leads to The Land of Unlaunched Vessels II: The Launchening.  Ahead of you, The Path Around the Liquor Store leads to The Land in Front of the Liquor Store.

>s
Anticlimactic Path
You are on the anticlimactic path.  Backwards is The Land of Unlaunched Vessels II: The Launchening.  Ahead of you, you can see the back of the liquor store.

>s
The Land of Unlaunched Vessels II: The Launchening
You are in The Land of Unlaunched Vessels II: The Launchening.  There is a launchpad here, on which sits a large, 1950's era rocket in galaxy white and candy-apple red. The Sequel Path leads backwards towards The Land of Unlaunched Vessels.  Ahead of you, The Anticlimactic Path probably leads somewhere really amazing.

You can see a launchpad and a rocket here.

>s
Sequel Path
You are on the sequel path.  Backwards from here is The Land of Unlaunched Vessels.  Forward is The Land of Unlaunched Vessels II: The Launchening.

>s
The Land of Unlaunched Vessels
You are in The Land of Unlaunched Vessels.  You stand near the edge of the bay, and there is a sailing ship moored here with thick and aged ropes tied to a bollard.  The Hopeful Path leads backward towards The Land of Unrealized Possibilities, a place you're not sure you want to be.  Forward, Sequel Path leads to The Land of Unlaunched Vessels II: The Launchening.

You can see a swarthy hippie seaperson here.

* * *

>throw block
You check to make sure Mister Tuxedo is looking, and then you whip the wooden block as far as you can.

>s
Idyllic Path
You are on the idyllic path.  Backwards from here is the liquor store, probably.  Forward is The Land of Puppy Cardiovascular Health.

* * *

>s
The Land of Unlaunched Vessels
You are in The Land of Unlaunched Vessels.  You stand near the edge of the bay, and there is a sailing ship moored here with thick and aged ropes tied to a bollard.  The Hopeful Path leads backward towards The Land of Unrealized Possibilities, a place you're not sure you want to be.  Forward, Sequel Path leads to The Land of Unlaunched Vessels II: The Launchening.

You can see a swarthy hippie seaperson here.

>s
Seaside Path
You are on the seaside path.  Backwards from here is The Land of Unrealized Possibilities.  Forward is The Land of Unlaunched Vessels.

* * *

>test tuxedo
(Testing.)

>throw lite
That's not the kind of thing that would be good to throw to a puppy, so you just set it down at your feet instead.

>ge tblock
That's not a verb I recognize.

>get block
Taken.

>throw block
You check to make sure Mister Tuxedo is looking, and then you whip the wooden block as far as you can.

The wooden block arcs through the air and tumbles to the ground a little ways away.  Mister Tuxedo hardly managed to get up to a full run before he gets to the block and gingerly picks it up.  He trots over and sets it near you.  He's eager to fetch again.  You didn't really get him up to full speed.

>throw doll
You check to make sure Mister Tuxedo is looking, and then you whip the skinny naked plastic doll as far as you can.

The skinny naked plastic doll flies end-over-end and lands not very far from you, and Mister Tuxedo leaps upon it.  He picks it up, whips it around a bit in his mouth, to make sure it's been pacified, trots over, and drops it near you.  He's ready to fetch again.  You didn't really get him up to full speed.

>look
The Land of Puppy Cardiovascular Health
The meadows are wide and rolling here.  Mister Tuxedo leaps and cavorts excitedly, barking every now and again.

You can see a skinny naked plastic doll, a wooden block, a lite-brite (empty), a post, and a power outlet here.

>get tennis
You can't see any such thing.

>throw tennis
You can't see any such thing.

* * *

>test tuxedo
(Testing.)

>tuxedo, fetch
Mister Tuxedo doesn't recognize the command, but he will probably fetch something you throw if he's interested.

I beg your pardon?

>tuxedo, sit
Mister Tuxedo cocks his head and sits for a moment, but he doesn't stay sitting for long.

>tuxedo, stay
Mister Tuxedo cocks his head and sits for a moment, but he doesn't stay sitting for long.

>tuxedo, roll
Mister Tuxedo looks at you quizzically for a moment, but then, to your surprise, actually rolls over quickly.  He barks as if it's not his favorite trick.

>tuxedo, roll over
Mister Tuxedo looks at you quizzically for a moment, but then, to your surprise, actually rolls over quickly.  He barks as if it's not his favorite trick.

>tuxedo speak
That's not a verb I recognize.

>tuxedo, speak
Mister Tuxedo gives a curt bark, and then a little awoo, so you know he was responding to your command.

>tell tuxedo to speak
You can't see any such thing.

>ask tuxedo to speak
You can't see any such thing.

>play with jack
You grasp the little wooden ball and begin to turn the crank as you hold the jack-in-the-box steady.  A dark little tune plinks its way out, echoing forth from the little tin box.  It's not "all around the mulberry bush" or any song you recognize, so you don't quite expect it when its last note ends, and the spring-loaded doll within leaps out with surprising agility.  You jump a tiny bit, in spite of yourself.  The devil doll looks pleased.

Mister Tuxedo lets out a sharp "Yipe!" and eyes you warily.

* * *

>test tuxedo
(Testing.)

>x mr tuxedo
Mr. Tuxedo is a young, healthy dog in the very prime of his life.  He's black all over except the tips of his front paws, and the bottom of his chin and belly, giving him the appearance of permanent formalwear.

>x mr. tuxedo
Mr. Tuxedo is a young, healthy dog in the very prime of his life.  He's black all over except the tips of his front paws, and the bottom of his chin and belly, giving him the appearance of permanent formalwear.

That's not a verb I recognize.

* * *

>turn
What do you want to turn?

>turn north
You must name something more substantial.

>n
The Land of Breakfast and Lunch
The Land of Breakfast and Lunch is a lot smaller than you were expecting.  It's actually just a small clearing near the road, like a roadside stop, with a painted picnic table containing a simple but nourishing breakfast on one end, and a simple but nourishing lunch on the other end.  A stubby little path leads backwards, and the path continues forward, towards The Land of Unrealized Possibilities.  If you "walk forward" or just "forward" or even just "f" you will be walking towards it.

You can see a painted picnic table (on which are Breakfast and Lunch) here.

>turn table
you do

>turn north
You must name something more substantial.

* * *

>turn north
You must name something more substantial.

* * *

>turn table
It is fixed in place.

* * *

>turn north
You must name something more substantial.

>turn path
You can't see any such thing.

>n
The Land of Breakfast and Lunch
The Land of Breakfast and Lunch is a lot smaller than you were expecting.  It's actually just a small clearing near the road, like a roadside stop, with a painted picnic table containing a simple but nourishing breakfast on one end, and a simple but nourishing lunch on the other end.  A stubby little path leads backwards, and the path continues forward, towards The Land of Unrealized Possibilities.  If you "walk forward" or just "forward" or even just "f" you will be walking towards it.

You can see a painted picnic table (on which are Breakfast and Lunch) here.

>turn table
You can't see any such thing.

>turn picnic table
You can't see any such thing.

>turn breakfast
You can't see any such thing.

>n
Hopeful Path
You are on the hopeful path.  Backwards from here is The Land of Breakfast and Lunch.  Forward is The Land of Unrealized Possibilities.

>n
The Land of Unrealized Possibilities
You are in the Land of Unrealized Possibilities.  Just being here gives you a sense of all that could be accomplished if enough time, effort, and focus were pointed in a specific direction.  There is an sense of both excitement and disappointment here that is almost palpable.  The Hopeful Path leads backward towards The Land of Breakfast and Lunch, a place with a much clearer sense of purpose.

You can see a toy box (closed), a couch (on which is your brother), and a TV here.

>turn box
You can't see any such thing.

>look box
It is a large simple wooden toy box stained with a nice hand-painted varnish.  It has a hinged lid on top.

* * *

>use
I didn't understand that sentence.

>use path
I didn't understand that sentence.

>f
The Land of Breakfast and Lunch
The Land of Breakfast and Lunch is a lot smaller than you were expecting.  It's actually just a small clearing near the road, like a roadside stop, with a painted picnic table containing a simple but nourishing breakfast on one end, and a simple but nourishing lunch on the other end.  A stubby little path leads backwards, and the path continues forward, towards The Land of Unrealized Possibilities.  If you "walk forward" or just "forward" or even just "f" you will be walking towards it.

You can see a painted picnic table (on which are Breakfast and Lunch) here.

>use table
I didn't understand that sentence.

>use the table
I didn't understand that sentence.

>use handle
You must supply a noun.

* * *

>wait
You stop doing anything for exactly 208 seconds.  Nothing seems to have changed in that time.

>wait
You stop doing anything for exactly 205 seconds.  Nothing seems to have changed in that time.

>wait
You stop doing anything for exactly 94 seconds.  Nothing seems to have changed in that time.

>wait
You stop doing anything for exactly 124 seconds.  Nothing seems to have changed in that time.

>s
This really is as far back as the path goes.  Further behind you there's just a bunch of scrub brush as far as the eye can see.  It's really not your kind of thing.

* * *

>wake up
You are already quite alert.

>sleep
You don't feel even the tendrils of sleepiness, you could lie down, but it sounds pretty boring.

* * *

>x path
Which do you mean, Southmostpath, Hopeypath, or Seapath?

>follow it
I only understood you as far as wanting to examine north.

>follow path
The Land of Breakfast and Lunch
The Land of Breakfast and Lunch is a lot smaller than you were expecting.  It's actually just a small clearing near the road, like a roadside stop, with a painted picnic table containing a simple but nourishing breakfast on one end, and a simple but nourishing lunch on the other end.  A stubby little path leads backwards, and the path continues forward, towards The Land of Unrealized Possibilities.  If you "walk forward" or just "forward" or even just "f" you will be walking towards it.

You can see a painted picnic table (on which are Breakfast and Lunch) here.

>follow
That's not a verb I recognize.

>follow path
Hopeful Path
You are on the hopeful path.  Backwards from here is The Land of Breakfast and Lunch.  Forward is The Land of Unrealized Possibilities.

>follow path
The Land of Unrealized Possibilities
You are in the Land of Unrealized Possibilities.  Just being here gives you a sense of all that could be accomplished if enough time, effort, and focus were pointed in a specific direction.  There is a sense of both excitement and disappointment here that is almost palpable.  The Hopeful Path leads backward towards The Land of Breakfast and Lunch, a place with a much clearer sense of purpose.  The Seaside Path leads forward, towards The Land of Unlaunched Vessels.

You can see a toy box (closed), a couch (on which is your brother), and a TV here.

>follow it
Seaside Path
You are on the seaside path.  Backwards from here is The Land of Unrealized Possibilities.  Forward is The Land of Unlaunched Vessels.

>follow it
The Land of Unlaunched Vessels
You are in The Land of Unlaunched Vessels.  You stand near the edge of the bay, and there is a sailing ship moored here with thick and aged ropes tied to a bollard.  The Hopeful Path leads backward towards The Land of Unrealized Possibilities, a place you're not sure you want to be.  Forward, Sequel Path leads to The Land of Unlaunched Vessels II: The Launchening.

You can see a swarthy hippie seaperson here.